GEO.id,GEO.id2,GEO.display-label,GEO.annotation.id,YEAR.id,GOVEMPFUNCT.id,GOVEMPFUNCT.display-label,EMPFT,PAYANNFT,EMPPT,PAYANNPT,HRSPT,EMPFTE,EMP,PAYANN
0100000US,,United States,,2014,1000,Total - All Government Employment Functions,3740501,18904367213,1589031,2215861769,102727758,4330051,5329532,21120228982
0100000US,,United States,,2014,1020,Financial Administration,163723,781711236,9377,19790352,1001753,169481,173100,801501588
0100000US,,United States,,2014,1040,Other Government Administration,47038,229852908,10112,20757538,884304,52121,57150,250610446
0100000US,,United States,,2014,1060,Judicial and Legal,168691,929780802,9259,22878731,815302,173339,177950,952659533
0100000US,,United States,,2014,1100,Police Protection Total,100279,578347039,2803,4222536,181761,101325,103082,582569575
0100000US,,United States,,2014,1101,Police Protection - Persons with Power of Arrest       ,64174,426537442,515,529780,18652,64281,64689,427067222
0100000US,,United States,,2014,1102,Police Protection - Other ,36105,151809597,2288,3692756,163109,37044,38393,155502353
0100000US,,United States,,2014,1120,Fire Protection Total ,0,0,0,0,0,0,0,0
0100000US,,United States,,2014,1121,Fire Protection - Firefighters,0,0,0,0,0,0,0,0
0100000US,,United States,,2014,1122,Fire Protection - Other ,0,0,0,0,0,0,0,0
0100000US,,United States,,2014,1140,Corrections,434284,1937046150,9427,26042273,989860,439917,443711,1963088423
0100000US,,United States,,2014,1160,Highways,210122,993092080,11524,29118845,1112893,216554,221646,1022210925
0100000US,,United States,,2014,1180,Air Transportation,3197,17601150,63,129500,5710,3231,3260,17730650
0100000US,,United States,,2014,1200,Water Transport and Terminals       ,4573,25724325,118,247450,9941,4629,4691,25971775
0100000US,,United States,,2014,1220,Public Welfare,233180,917964484,10749,25391875,1209400,240104,243929,943356359
0100000US,,United States,,2014,1240,Health,173023,798222782,16553,39373413,1474455,181437,189576,837596195
0100000US,,United States,,2014,1260,Hospitals,354405,1699755828,78408,272934079,7937758,399630,432813,1972689907
0100000US,,United States,,2014,1280,Social Insurance Administration,72375,319820144,5335,13235187,563175,75615,77710,333055331
0100000US,,United States,,2014,1300,Solid Waste Management,2216,12907887,203,548054,23388,2349,2419,13455941
0100000US,,United States,,2014,1320,Sewerage,1684,10656757,51,282308,4565,1711,1735,10939065
0100000US,,United States,,2014,1340,Parks and Recreation,29980,108150983,10647,13716192,954060,35471,40627,121867175
0100000US,,United States,,2014,1360,Housing and Community Development,597,3363416,63,149862,6511,634,660,3513278
0100000US,,United States,,2014,1380,Natural Resources,120349,553966543,25596,39454354,2151950,132640,145945,593420897
0100000US,,United States,,2014,1400,Water Supply,700,3938018,26,56995,1598,710,726,3995013
0100000US,,United States,,2014,1420,Electric Power,3958,27817976,53,155823,4711,3984,4011,27973799
0100000US,,United States,,2014,1440,Gas Supply,0,0,0,0,0,0,0,0
0100000US,,United States,,2014,1460,Transit,31279,201203068,1449,2751418,135224,32044,32728,203954486
0100000US,,United States,,2014,1480,Education Total ,1412266,7909260314,1367218,1650358595,81613386,1881065,2779484,9559618909
0100000US,,United States,,2014,1481,Education - Elementary and Secondary Total ,42109,211831565,18328,20496376,1104238,48883,60437,232327941
0100000US,,United States,,2014,14811,Education - Elementary and Secondary Instructional             ,31635,173451208,12956,13602564,716346,35976,44591,187053772
0100000US,,United States,,2014,14812,Education - Elementary and Secondary Other ,10474,38380357,5372,6893812,387892,12907,15846,45274169
0100000US,,United States,,2014,1482,Education - Higher Education Total ,1291013,7329796865,1336039,1607641650,79497714,1747243,2627052,8937438515
0100000US,,United States,,2014,14821,Education - Higher Education Instructional,413624,3235764991,430409,784305683,27115537,569378,844033,4020070674
0100000US,,United States,,2014,14822,Education - Higher Education Other ,877389,4094031874,905630,823335967,52382177,1177865,1783019,4917367841
0100000US,,United States,,2014,1483,Education - Other,79144,367631884,12851,22220569,1011434,84939,91995,389852453
0100000US,,United States,,2014,1500,Libraries                          ,532,1952018,245,210690,17904,633,777,2162708
0100000US,,United States,,2014,1560,State liquor stores,6048,20887169,5935,8301647,508742,9029,11983,29188816
0100000US,,United States,,2014,1580,All other and unallocable,166002,821344136,13817,25754052,1119407,172398,179819,847098188
0400000US01,01,Alabama,,2014,1000,Total - All Government Employment Functions,78120,343733577,30725,31728888,1832271,88715,108845,375462465
0400000US01,01,Alabama,,2014,1020,Financial Administration,2429,10640190,65,87120,5962,2463,2494,10727310
0400000US01,01,Alabama,,2014,1040,Other Government Administration,496,2516132,216,723300,23619,629,712,3239432
0400000US01,01,Alabama,,2014,1060,Judicial and Legal,3038,14222664,235,403690,27883,3195,3273,14626354
0400000US01,01,Alabama,,2014,1100,Police Protection Total,1367,5115714,0,0,0,1367,1367,5115714
0400000US01,01,Alabama,,2014,1101,Police Protection - Persons with Power of Arrest       ,689,3114570,0,0,0,689,689,3114570
0400000US01,01,Alabama,,2014,1102,Police Protection - Other ,678,2001144,0,0,0,678,678,2001144
0400000US01,01,Alabama,,2014,1120,Fire Protection Total ,0,0,0,0,0,0,0,0
0400000US01,01,Alabama,,2014,1121,Fire Protection - Firefighters,0,0,0,0,0,0,0,0
0400000US01,01,Alabama,,2014,1122,Fire Protection - Other ,0,0,0,0,0,0,0,0
0400000US01,01,Alabama,,2014,1140,Corrections,4778,15867932,137,255708,11188,4841,4915,16123640
0400000US01,01,Alabama,,2014,1160,Highways,4190,14279100,61,45920,4734,4217,4251,14325020
0400000US01,01,Alabama,,2014,1180,Air Transportation,0,0,0,0,0,0,0,0
0400000US01,01,Alabama,,2014,1200,Water Transport and Terminals       ,584,2832054,1,1775,80,584,585,2833829
0400000US01,01,Alabama,,2014,1220,Public Welfare,3909,13585608,93,160246,7974,3954,4002,13745854
0400000US01,01,Alabama,,2014,1240,Health,4239,17417356,269,328624,18270,4342,4508,17745980
0400000US01,01,Alabama,,2014,1260,Hospitals,11080,46919768,1726,3572003,133786,11874,12806,50491771
0400000US01,01,Alabama,,2014,1280,Social Insurance Administration,903,3339512,79,103532,10216,961,982,3443044
0400000US01,01,Alabama,,2014,1300,Solid Waste Management,0,0,0,0,0,0,0,0
0400000US01,01,Alabama,,2014,1320,Sewerage,0,0,0,0,0,0,0,0
0400000US01,01,Alabama,,2014,1340,Parks and Recreation,367,1071930,279,286750,34098,560,646,1358680
0400000US01,01,Alabama,,2014,1360,Housing and Community Development,0,0,0,0,0,0,0,0
0400000US01,01,Alabama,,2014,1380,Natural Resources,1941,7203936,137,152426,10763,2002,2078,7356362
0400000US01,01,Alabama,,2014,1400,Water Supply,0,0,0,0,0,0,0,0
0400000US01,01,Alabama,,2014,1420,Electric Power,0,0,0,0,0,0,0,0
0400000US01,01,Alabama,,2014,1440,Gas Supply,0,0,0,0,0,0,0,0
0400000US01,01,Alabama,,2014,1460,Transit,0,0,0,0,0,0,0,0
0400000US01,01,Alabama,,2014,1480,Education Total ,36153,178736690,26704,24769572,1470851,44670,62857,203506262
0400000US01,01,Alabama,,2014,1481,Education - Elementary and Secondary Total ,0,0,0,0,0,0,0,0
0400000US01,01,Alabama,,2014,14811,Education - Elementary and Secondary Instructional             ,0,0,0,0,0,0,0,0
0400000US01,01,Alabama,,2014,14812,Education - Elementary and Secondary Other ,0,0,0,0,0,0,0,0
0400000US01,01,Alabama,,2014,1482,Education - Higher Education Total ,33281,167542191,26522,24545901,1461691,41747,59803,192088092
0400000US01,01,Alabama,,2014,14821,Education - Higher Education Instructional,9893,75359961,8837,11265721,462071,12561,18730,86625682
0400000US01,01,Alabama,,2014,14822,Education - Higher Education Other ,23388,92182230,17685,13280180,999620,29186,41073,105462410
0400000US01,01,Alabama,,2014,1483,Education - Other,2872,11194499,182,223671,9160,2923,3054,11418170
0400000US01,01,Alabama,,2014,1500,Libraries                          ,0,0,0,0,0,0,0,0
0400000US01,01,Alabama,,2014,1560,State liquor stores,741,2000236,13,24438,1452,749,754,2024674
0400000US01,01,Alabama,,2014,1580,All other and unallocable,1905,7984755,710,813784,71395,2307,2615,8798539
0400000US02,02,Alaska,,2014,1000,Total - All Government Employment Functions,25068,141572839,4899,6135427,340246,27049,29967,147708266
0400000US02,02,Alaska,,2014,1020,Financial Administration,1101,6652670,29,45908,2152,1113,1130,6698578
0400000US02,02,Alaska,,2014,1040,Other Government Administration,737,4177438,41,58934,2458,752,778,4236372
0400000US02,02,Alaska,,2014,1060,Judicial and Legal,1486,9476004,41,93804,2774,1503,1527,9569808
0400000US02,02,Alaska,,2014,1100,Police Protection Total,677,4642166,42,63836,3104,696,719,4706002
0400000US02,02,Alaska,,2014,1101,Police Protection - Persons with Power of Arrest       ,310,2779906,0,0,0,310,310,2779906
0400000US02,02,Alaska,,2014,1102,Police Protection - Other ,367,1862260,42,63836,3104,386,409,1926096
0400000US02,02,Alaska,,2014,1120,Fire Protection Total ,0,0,0,0,0,0,0,0
0400000US02,02,Alaska,,2014,1121,Fire Protection - Firefighters,0,0,0,0,0,0,0,0
0400000US02,02,Alaska,,2014,1122,Fire Protection - Other ,0,0,0,0,0,0,0,0
0400000US02,02,Alaska,,2014,1140,Corrections,2196,12589446,53,109052,6872,2238,2249,12698498
0400000US02,02,Alaska,,2014,1160,Highways,3157,18516548,63,103108,5104,3188,3220,18619656
0400000US02,02,Alaska,,2014,1180,Air Transportation,0,0,0,0,0,0,0,0
0400000US02,02,Alaska,,2014,1200,Water Transport and Terminals       ,0,0,0,0,0,0,0,0
0400000US02,02,Alaska,,2014,1220,Public Welfare,1828,9081878,119,205946,17542,1934,1947,9287824
0400000US02,02,Alaska,,2014,1240,Health,728,4196612,18,39194,1276,736,746,4235806
0400000US02,02,Alaska,,2014,1260,Hospitals,226,1243194,34,84232,4734,255,260,1327426
0400000US02,02,Alaska,,2014,1280,Social Insurance Administration,323,1590378,2,6136,174,324,325,1596514
0400000US02,02,Alaska,,2014,1300,Solid Waste Management,0,0,0,0,0,0,0,0
0400000US02,02,Alaska,,2014,1320,Sewerage,0,0,0,0,0,0,0,0
0400000US02,02,Alaska,,2014,1340,Parks and Recreation,115,504742,1,2788,86,116,116,507530
0400000US02,02,Alaska,,2014,1360,Housing and Community Development,0,0,0,0,0,0,0,0
0400000US02,02,Alaska,,2014,1380,Natural Resources,2373,13525883,80,143638,5839,2409,2453,13669521
0400000US02,02,Alaska,,2014,1400,Water Supply,0,0,0,0,0,0,0,0
0400000US02,02,Alaska,,2014,1420,Electric Power,0,0,0,0,0,0,0,0
0400000US02,02,Alaska,,2014,1440,Gas Supply,0,0,0,0,0,0,0,0
0400000US02,02,Alaska,,2014,1460,Transit,0,0,0,0,0,0,0,0
0400000US02,02,Alaska,,2014,1480,Education Total ,7349,38640514,4324,5108075,284941,8992,11673,43748589
0400000US02,02,Alaska,,2014,1481,Education - Elementary and Secondary Total ,2634,11279748,1280,1381265,77226,3103,3914,12661013
0400000US02,02,Alaska,,2014,14811,Education - Elementary and Secondary Instructional             ,1965,8993063,616,711198,40163,2209,2581,9704261
0400000US02,02,Alaska,,2014,14812,Education - Elementary and Secondary Other ,669,2286685,664,670067,37063,894,1333,2956752
0400000US02,02,Alaska,,2014,1482,Education - Higher Education Total ,4453,25832822,3011,3688006,205581,5614,7464,29520828
0400000US02,02,Alaska,,2014,14821,Education - Higher Education Instructional,1238,10608173,1067,1528282,62711,1592,2305,12136455
0400000US02,02,Alaska,,2014,14822,Education - Higher Education Other ,3215,15224649,1944,2159724,142870,4022,5159,17384373
0400000US02,02,Alaska,,2014,1483,Education - Other,262,1527944,33,38804,2134,275,295,1566748
0400000US02,02,Alaska,,2014,1500,Libraries                          ,0,0,0,0,0,0,0,0
0400000US02,02,Alaska,,2014,1560,State liquor stores,0,0,0,0,0,0,0,0
0400000US02,02,Alaska,,2014,1580,All other and unallocable,2772,16735366,52,70776,3190,2793,2824,16806142
0400000US04,04,Arizona,,2014,1000,Total - All Government Employment Functions,65828,309231726,30516,36471289,2272692,78671,96344,345703015
0400000US04,04,Arizona,,2014,1020,Financial Administration,2456,9511852,37,80239,3065,2473,2493,9592091
0400000US04,04,Arizona,,2014,1040,Other Government Administration,737,3021669,94,196193,6779,776,831,3217862
0400000US04,04,Arizona,,2014,1060,Judicial and Legal,2094,10007235,70,226211,6588,2131,2164,10233446
0400000US04,04,Arizona,,2014,1100,Police Protection Total,1903,9584794,60,123753,4419,1928,1963,9708547
0400000US04,04,Arizona,,2014,1101,Police Protection - Persons with Power of Arrest       ,1140,6260963,2,3612,159,1141,1142,6264575
0400000US04,04,Arizona,,2014,1102,Police Protection - Other ,763,3323831,58,120141,4260,787,821,3443972
0400000US04,04,Arizona,,2014,1120,Fire Protection Total ,0,0,0,0,0,0,0,0
0400000US04,04,Arizona,,2014,1121,Fire Protection - Firefighters,0,0,0,0,0,0,0,0
0400000US04,04,Arizona,,2014,1122,Fire Protection - Other ,0,0,0,0,0,0,0,0
0400000US04,04,Arizona,,2014,1140,Corrections,9579,34690262,18,53496,1304,9586,9597,34743758
0400000US04,04,Arizona,,2014,1160,Highways,2973,12900486,34,63984,2276,2986,3007,12964470
0400000US04,04,Arizona,,2014,1180,Air Transportation,0,0,0,0,0,0,0,0
0400000US04,04,Arizona,,2014,1200,Water Transport and Terminals       ,0,0,0,0,0,0,0,0
0400000US04,04,Arizona,,2014,1220,Public Welfare,5658,18897704,97,216796,10008,5715,5755,19114500
0400000US04,04,Arizona,,2014,1240,Health,2340,9930260,33,99853,3562,2361,2373,10030113
0400000US04,04,Arizona,,2014,1260,Hospitals,6344,29629156,1134,3690225,124392,7046,7478,33319381
0400000US04,04,Arizona,,2014,1280,Social Insurance Administration,1920,5671076,51,71621,4666,1946,1971,5742697
0400000US04,04,Arizona,,2014,1300,Solid Waste Management,0,0,0,0,0,0,0,0
0400000US04,04,Arizona,,2014,1320,Sewerage,0,0,0,0,0,0,0,0
0400000US04,04,Arizona,,2014,1340,Parks and Recreation,352,915824,4,1404,38,352,356,917228
0400000US04,04,Arizona,,2014,1360,Housing and Community Development,0,0,0,0,0,0,0,0
0400000US04,04,Arizona,,2014,1380,Natural Resources,1406,5986805,210,348662,21271,1526,1616,6335467
0400000US04,04,Arizona,,2014,1400,Water Supply,0,0,0,0,0,0,0,0
0400000US04,04,Arizona,,2014,1420,Electric Power,6,48588,0,0,0,6,6,48588
0400000US04,04,Arizona,,2014,1440,Gas Supply,0,0,0,0,0,0,0,0
0400000US04,04,Arizona,,2014,1460,Transit,0,0,0,0,0,0,0,0
0400000US04,04,Arizona,,2014,1480,Education Total ,24903,144647124,28494,31050932,2072799,36613,53397,175698056
0400000US04,04,Arizona,,2014,1481,Education - Elementary and Secondary Total ,0,0,0,0,0,0,0,0
0400000US04,04,Arizona,,2014,14811,Education - Elementary and Secondary Instructional             ,0,0,0,0,0,0,0,0
0400000US04,04,Arizona,,2014,14812,Education - Elementary and Secondary Other ,0,0,0,0,0,0,0,0
0400000US04,04,Arizona,,2014,1482,Education - Higher Education Total ,22103,134339502,28206,30583209,2044216,33651,50309,164922711
0400000US04,04,Arizona,,2014,14821,Education - Higher Education Instructional,7163,55545321,10461,13731945,725651,11262,17624,69277266
0400000US04,04,Arizona,,2014,14822,Education - Higher Education Other ,14940,78794181,17745,16851264,1318565,22389,32685,95645445
0400000US04,04,Arizona,,2014,1483,Education - Other,2800,10307622,288,467723,28583,2962,3088,10775345
0400000US04,04,Arizona,,2014,1500,Libraries                          ,0,0,0,0,0,0,0,0
0400000US04,04,Arizona,,2014,1560,State liquor stores,0,0,0,0,0,0,0,0
0400000US04,04,Arizona,,2014,1580,All other and unallocable,3157,13788891,180,247920,11525,3226,3337,14036811
0400000US05,05,Arkansas,,2014,1000,Total - All Government Employment Functions,57220,229653824,15899,15161005,875179,62170,73119,244814829
0400000US05,05,Arkansas,,2014,1020,Financial Administration,2281,8967935,14,25993,1714,2291,2295,8993928
0400000US05,05,Arkansas,,2014,1040,Other Government Administration,701,3182388,176,242657,13092,775,877,3425045
0400000US05,05,Arkansas,,2014,1060,Judicial and Legal,1312,5054398,143,447795,12799,1385,1455,5502193
0400000US05,05,Arkansas,,2014,1100,Police Protection Total,1233,4674509,14,22725,1449,1242,1247,4697234
0400000US05,05,Arkansas,,2014,1101,Police Protection - Persons with Power of Arrest       ,557,2483586,0,0,0,557,557,2483586
0400000US05,05,Arkansas,,2014,1102,Police Protection - Other ,676,2190923,14,22725,1449,685,690,2213648
0400000US05,05,Arkansas,,2014,1120,Fire Protection Total ,0,0,0,0,0,0,0,0
0400000US05,05,Arkansas,,2014,1121,Fire Protection - Firefighters,0,0,0,0,0,0,0,0
0400000US05,05,Arkansas,,2014,1122,Fire Protection - Other ,0,0,0,0,0,0,0,0
0400000US05,05,Arkansas,,2014,1140,Corrections,5552,17580647,10,18602,989,5557,5562,17599249
0400000US05,05,Arkansas,,2014,1160,Highways,3353,13313400,28,55201,3594,3373,3381,13368601
0400000US05,05,Arkansas,,2014,1180,Air Transportation,3,19601,0,0,0,3,3,19601
0400000US05,05,Arkansas,,2014,1200,Water Transport and Terminals       ,0,0,0,0,0,0,0,0
0400000US05,05,Arkansas,,2014,1220,Public Welfare,4047,12714423,53,71233,4054,4070,4100,12785656
0400000US05,05,Arkansas,,2014,1240,Health,3672,14007506,147,334274,14501,3755,3819,14341780
0400000US05,05,Arkansas,,2014,1260,Hospitals,6418,23777825,527,984537,61048,6763,6945,24762362
0400000US05,05,Arkansas,,2014,1280,Social Insurance Administration,1179,4253255,7,36737,903,1184,1186,4289992
0400000US05,05,Arkansas,,2014,1300,Solid Waste Management,0,0,0,0,0,0,0,0
0400000US05,05,Arkansas,,2014,1320,Sewerage,0,0,0,0,0,0,0,0
0400000US05,05,Arkansas,,2014,1340,Parks and Recreation,966,2133238,0,0,0,966,966,2133238
0400000US05,05,Arkansas,,2014,1360,Housing and Community Development,0,0,0,0,0,0,0,0
0400000US05,05,Arkansas,,2014,1380,Natural Resources,1827,6606053,367,276768,22224,1953,2194,6882821
0400000US05,05,Arkansas,,2014,1400,Water Supply,0,0,0,0,0,0,0,0
0400000US05,05,Arkansas,,2014,1420,Electric Power,0,0,0,0,0,0,0,0
0400000US05,05,Arkansas,,2014,1440,Gas Supply,0,0,0,0,0,0,0,0
0400000US05,05,Arkansas,,2014,1460,Transit,0,0,0,0,0,0,0,0
0400000US05,05,Arkansas,,2014,1480,Education Total ,22654,105660588,14374,12591240,735860,26814,37028,118251828
0400000US05,05,Arkansas,,2014,1481,Education - Elementary and Secondary Total ,0,0,0,0,0,0,0,0
0400000US05,05,Arkansas,,2014,14811,Education - Elementary and Secondary Instructional             ,0,0,0,0,0,0,0,0
0400000US05,05,Arkansas,,2014,14812,Education - Elementary and Secondary Other ,0,0,0,0,0,0,0,0
0400000US05,05,Arkansas,,2014,1482,Education - Higher Education Total ,21289,100456611,14356,12555507,734177,25438,35645,113012118
0400000US05,05,Arkansas,,2014,14821,Education - Higher Education Instructional,6629,48607630,5529,6941304,326907,8475,12158,55548934
0400000US05,05,Arkansas,,2014,14822,Education - Higher Education Other ,14660,51848981,8827,5614203,407270,16963,23487,57463184
0400000US05,05,Arkansas,,2014,1483,Education - Other,1365,5203977,18,35733,1683,1376,1383,5239710
0400000US05,05,Arkansas,,2014,1500,Libraries                          ,49,160486,0,0,0,49,49,160486
0400000US05,05,Arkansas,,2014,1560,State liquor stores,0,0,0,0,0,0,0,0
0400000US05,05,Arkansas,,2014,1580,All other and unallocable,1973,7547572,39,53243,2952,1990,2012,7600815
0400000US06,06,California,,2014,1000,Total - All Government Employment Functions,333050,2227704726,166112,373775445,12711885,404879,499162,2601480171
0400000US06,06,California,,2014,1020,Financial Administration,25031,126448079,2767,5710505,328390,26886,27798,132158584
0400000US06,06,California,,2014,1040,Other Government Administration,3777,21500145,342,953048,32545,3975,4119,22453193
0400000US06,06,California,,2014,1060,Judicial and Legal,6167,41115236,553,1226718,32994,6355,6720,42341954
0400000US06,06,California,,2014,1100,Police Protection Total,11310,88874562,243,176349,6443,11347,11553,89050911
0400000US06,06,California,,2014,1101,Police Protection - Persons with Power of Arrest       ,7761,73727719,191,74565,1784,7771,7952,73802284
0400000US06,06,California,,2014,1102,Police Protection - Other ,3549,15146843,52,101784,4659,3576,3601,15248627
0400000US06,06,California,,2014,1120,Fire Protection Total ,0,0,0,0,0,0,0,0
0400000US06,06,California,,2014,1121,Fire Protection - Firefighters,0,0,0,0,0,0,0,0
0400000US06,06,California,,2014,1122,Fire Protection - Other ,0,0,0,0,0,0,0,0
0400000US06,06,California,,2014,1140,Corrections,52312,387740179,1804,6209725,192133,53397,54116,393949904
0400000US06,06,California,,2014,1160,Highways,18758,145549790,1098,4850425,163383,19680,19856,150400215
0400000US06,06,California,,2014,1180,Air Transportation,0,0,0,0,0,0,0,0
0400000US06,06,California,,2014,1200,Water Transport and Terminals       ,0,0,0,0,0,0,0,0
0400000US06,06,California,,2014,1220,Public Welfare,3538,17372297,288,616404,20280,3653,3826,17988701
0400000US06,06,California,,2014,1240,Health,13417,84038701,2241,6749779,255248,14858,15658,90788480
0400000US06,06,California,,2014,1260,Hospitals,30437,229509385,17514,104993211,2120115,42416,47951,334502596
0400000US06,06,California,,2014,1280,Social Insurance Administration,13120,67752780,1265,3538140,136946,13894,14385,71290920
0400000US06,06,California,,2014,1300,Solid Waste Management,599,3473251,84,177816,8993,650,683,3651067
0400000US06,06,California,,2014,1320,Sewerage,0,0,0,0,0,0,0,0
0400000US06,06,California,,2014,1340,Parks and Recreation,2115,11100835,1996,3028587,206295,3280,4111,14129422
0400000US06,06,California,,2014,1360,Housing and Community Development,0,0,0,0,0,0,0,0
0400000US06,06,California,,2014,1380,Natural Resources,13754,87617381,2699,4700950,330578,15619,16453,92318331
0400000US06,06,California,,2014,1400,Water Supply,0,0,0,0,0,0,0,0
0400000US06,06,California,,2014,1420,Electric Power,0,0,0,0,0,0,0,0
0400000US06,06,California,,2014,1440,Gas Supply,0,0,0,0,0,0,0,0
0400000US06,06,California,,2014,1460,Transit,0,0,0,0,0,0,0,0
0400000US06,06,California,,2014,1480,Education Total ,119313,797929806,131384,226307579,8746529,168730,250697,1024237385
0400000US06,06,California,,2014,1481,Education - Elementary and Secondary Total ,0,0,0,0,0,0,0,0
0400000US06,06,California,,2014,14811,Education - Elementary and Secondary Instructional             ,0,0,0,0,0,0,0,0
0400000US06,06,California,,2014,14812,Education - Elementary and Secondary Other ,0,0,0,0,0,0,0,0
0400000US06,06,California,,2014,1482,Education - Higher Education Total ,115249,777081152,130935,225475476,8707459,164445,246184,1002556628
0400000US06,06,California,,2014,14821,Education - Higher Education Instructional,25161,229935751,33189,64829103,1939743,36121,58350,294764854
0400000US06,06,California,,2014,14822,Education - Higher Education Other ,90088,547145401,97746,160646373,6767716,128324,187834,707791774
0400000US06,06,California,,2014,1483,Education - Other,4064,20848654,449,832103,39070,4285,4513,21680757
0400000US06,06,California,,2014,1500,Libraries                          ,0,0,0,0,0,0,0,0
0400000US06,06,California,,2014,1560,State liquor stores,0,0,0,0,0,0,0,0
0400000US06,06,California,,2014,1580,All other and unallocable,19402,117682299,1834,4536209,131013,20139,21236,122218508
0400000US08,08,Colorado,,2014,1000,Total - All Government Employment Functions,57780,310949390,46793,82486829,4097173,81631,104573,393436219
0400000US08,08,Colorado,,2014,1020,Financial Administration,1771,9071799,64,148227,7488,1812,1835,9220026
0400000US08,08,Colorado,,2014,1040,Other Government Administration,428,1934513,172,447174,25645,574,600,2381687
0400000US08,08,Colorado,,2014,1060,Judicial and Legal,4470,23518683,535,1587235,60160,4810,5005,25105918
0400000US08,08,Colorado,,2014,1100,Police Protection Total,1218,6715847,17,39125,1390,1226,1235,6754972
0400000US08,08,Colorado,,2014,1101,Police Protection - Persons with Power of Arrest       ,754,4572712,0,0,0,754,754,4572712
0400000US08,08,Colorado,,2014,1102,Police Protection - Other ,464,2143135,17,39125,1390,472,481,2182260
0400000US08,08,Colorado,,2014,1120,Fire Protection Total ,0,0,0,0,0,0,0,0
0400000US08,08,Colorado,,2014,1121,Fire Protection - Firefighters,0,0,0,0,0,0,0,0
0400000US08,08,Colorado,,2014,1122,Fire Protection - Other ,0,0,0,0,0,0,0,0
0400000US08,08,Colorado,,2014,1140,Corrections,7098,30148943,51,208548,7139,7139,7149,30357491
0400000US08,08,Colorado,,2014,1160,Highways,2949,14080013,181,488899,28358,3109,3130,14568912
0400000US08,08,Colorado,,2014,1180,Air Transportation,0,0,0,0,0,0,0,0
0400000US08,08,Colorado,,2014,1200,Water Transport and Terminals       ,0,0,0,0,0,0,0,0
0400000US08,08,Colorado,,2014,1220,Public Welfare,2145,9604266,315,789132,45774,2404,2460,10393398
0400000US08,08,Colorado,,2014,1240,Health,1191,6814997,151,506330,17526,1290,1342,7321327
0400000US08,08,Colorado,,2014,1260,Hospitals,4856,20356247,1044,4726507,157615,5791,5900,25082754
0400000US08,08,Colorado,,2014,1280,Social Insurance Administration,976,4643918,218,583288,33833,1167,1194,5227206
0400000US08,08,Colorado,,2014,1300,Solid Waste Management,0,0,0,0,0,0,0,0
0400000US08,08,Colorado,,2014,1320,Sewerage,0,0,0,0,0,0,0,0
0400000US08,08,Colorado,,2014,1340,Parks and Recreation,879,4372686,232,328621,19062,987,1111,4701307
0400000US08,08,Colorado,,2014,1360,Housing and Community Development,0,0,0,0,0,0,0,0
0400000US08,08,Colorado,,2014,1380,Natural Resources,976,5271187,224,419893,21032,1094,1200,5691080
0400000US08,08,Colorado,,2014,1400,Water Supply,0,0,0,0,0,0,0,0
0400000US08,08,Colorado,,2014,1420,Electric Power,0,0,0,0,0,0,0,0
0400000US08,08,Colorado,,2014,1440,Gas Supply,0,0,0,0,0,0,0,0
0400000US08,08,Colorado,,2014,1460,Transit,0,0,0,0,0,0,0,0
0400000US08,08,Colorado,,2014,1480,Education Total ,26494,161790468,43521,72030810,3662557,47846,70015,233821278
0400000US08,08,Colorado,,2014,1481,Education - Elementary and Secondary Total ,0,0,0,0,0,0,0,0
0400000US08,08,Colorado,,2014,14811,Education - Elementary and Secondary Instructional             ,0,0,0,0,0,0,0,0
0400000US08,08,Colorado,,2014,14812,Education - Elementary and Secondary Other ,0,0,0,0,0,0,0,0
0400000US08,08,Colorado,,2014,1482,Education - Higher Education Total ,25372,156014567,42385,70442520,3571947,46213,67757,226457087
0400000US08,08,Colorado,,2014,14821,Education - Higher Education Instructional,9491,79422072,15536,39267972,1547491,18565,25027,118690044
0400000US08,08,Colorado,,2014,14822,Education - Higher Education Other ,15881,76592495,26849,31174548,2024456,27648,42730,107767043
0400000US08,08,Colorado,,2014,1483,Education - Other,1122,5775901,1136,1588290,90610,1633,2258,7364191
0400000US08,08,Colorado,,2014,1500,Libraries                          ,0,0,0,0,0,0,0,0
0400000US08,08,Colorado,,2014,1560,State liquor stores,0,0,0,0,0,0,0,0
0400000US08,08,Colorado,,2014,1580,All other and unallocable,2329,12625823,68,183040,9594,2382,2397,12808863
0400000US09,09,Connecticut,,2014,1000,Total - All Government Employment Functions,53003,340330368,24387,41917537,1587129,62313,77390,382247905
0400000US09,09,Connecticut,,2014,1020,Financial Administration,1724,11060427,57,156711,4981,1752,1781,11217138
0400000US09,09,Connecticut,,2014,1040,Other Government Administration,1485,9419235,236,784050,25508,1629,1721,10203285
0400000US09,09,Connecticut,,2014,1060,Judicial and Legal,6087,36185018,333,921229,16434,6179,6420,37106247
0400000US09,09,Connecticut,,2014,1100,Police Protection Total,1913,13826882,241,169484,6211,1947,2154,13996366
0400000US09,09,Connecticut,,2014,1101,Police Protection - Persons with Power of Arrest       ,1258,9968192,3,4176,208,1259,1261,9972368
0400000US09,09,Connecticut,,2014,1102,Police Protection - Other ,655,3858690,238,165308,6003,688,893,4023998
0400000US09,09,Connecticut,,2014,1120,Fire Protection Total ,0,0,0,0,0,0,0,0
0400000US09,09,Connecticut,,2014,1121,Fire Protection - Firefighters,0,0,0,0,0,0,0,0
0400000US09,09,Connecticut,,2014,1122,Fire Protection - Other ,0,0,0,0,0,0,0,0
0400000US09,09,Connecticut,,2014,1140,Corrections,5730,36887356,65,229652,5695,5762,5795,37117008
0400000US09,09,Connecticut,,2014,1160,Highways,3184,17938936,7,26306,835,3189,3191,17965242
0400000US09,09,Connecticut,,2014,1180,Air Transportation,144,970466,0,0,0,144,144,970466
0400000US09,09,Connecticut,,2014,1200,Water Transport and Terminals       ,0,0,0,0,0,0,0,0
0400000US09,09,Connecticut,,2014,1220,Public Welfare,5143,32974326,420,1793227,60490,5484,5563,34767553
0400000US09,09,Connecticut,,2014,1240,Health,3621,22165436,499,1788271,43156,3883,4120,23953707
0400000US09,09,Connecticut,,2014,1260,Hospitals,5183,34054894,1808,7504697,226946,6465,6991,41559591
0400000US09,09,Connecticut,,2014,1280,Social Insurance Administration,693,4573973,2,2338,91,694,695,4576311
0400000US09,09,Connecticut,,2014,1300,Solid Waste Management,43,280213,3,8262,359,45,46,288475
0400000US09,09,Connecticut,,2014,1320,Sewerage,0,0,0,0,0,0,0,0
0400000US09,09,Connecticut,,2014,1340,Parks and Recreation,155,890307,18,26073,1149,161,173,916380
0400000US09,09,Connecticut,,2014,1360,Housing and Community Development,44,307219,0,0,0,44,44,307219
0400000US09,09,Connecticut,,2014,1380,Natural Resources,679,3938012,83,164291,5932,712,762,4102303
0400000US09,09,Connecticut,,2014,1400,Water Supply,0,0,0,0,0,0,0,0
0400000US09,09,Connecticut,,2014,1420,Electric Power,0,0,0,0,0,0,0,0
0400000US09,09,Connecticut,,2014,1440,Gas Supply,0,0,0,0,0,0,0,0
0400000US09,09,Connecticut,,2014,1460,Transit,0,0,0,0,0,0,0,0
0400000US09,09,Connecticut,,2014,1480,Education Total ,14748,99346267,20230,27781607,1164773,21658,34978,127127874
0400000US09,09,Connecticut,,2014,1481,Education - Elementary and Secondary Total ,0,0,0,0,0,0,0,0
0400000US09,09,Connecticut,,2014,14811,Education - Elementary and Secondary Instructional             ,0,0,0,0,0,0,0,0
0400000US09,09,Connecticut,,2014,14812,Education - Elementary and Secondary Other ,0,0,0,0,0,0,0,0
0400000US09,09,Connecticut,,2014,1482,Education - Higher Education Total ,12168,83278849,19274,25943754,1092248,18669,31442,109222603
0400000US09,09,Connecticut,,2014,14821,Education - Higher Education Instructional,4532,37625889,7808,14986515,438556,7170,12340,52612404
0400000US09,09,Connecticut,,2014,14822,Education - Higher Education Other ,7636,45652960,11466,10957239,653692,11499,19102,56610199
0400000US09,09,Connecticut,,2014,1483,Education - Other,2580,16067418,956,1837853,72525,2989,3536,17905271
0400000US09,09,Connecticut,,2014,1500,Libraries                          ,0,0,0,0,0,0,0,0
0400000US09,09,Connecticut,,2014,1560,State liquor stores,0,0,0,0,0,0,0,0
0400000US09,09,Connecticut,,2014,1580,All other and unallocable,2427,15511401,385,561339,24569,2565,2812,16072740
0400000US10,10,Delaware,,2014,1000,Total - All Government Employment Functions,23214,104852849,7513,9338676,476158,26083,30727,114191525
0400000US10,10,Delaware,,2014,1020,Financial Administration,809,2647819,24,24391,1223,816,833,2672210
0400000US10,10,Delaware,,2014,1040,Other Government Administration,391,1710555,98,131643,3703,414,489,1842198
0400000US10,10,Delaware,,2014,1060,Judicial and Legal,1774,8267291,47,96846,4828,1803,1821,8364137
0400000US10,10,Delaware,,2014,1100,Police Protection Total,1055,6860782,17,34851,1727,1065,1072,6895633
0400000US10,10,Delaware,,2014,1101,Police Protection - Persons with Power of Arrest       ,790,5565979,0,0,0,790,790,5565979
0400000US10,10,Delaware,,2014,1102,Police Protection - Other ,265,1294803,17,34851,1727,275,282,1329654
0400000US10,10,Delaware,,2014,1120,Fire Protection Total ,0,0,0,0,0,0,0,0
0400000US10,10,Delaware,,2014,1121,Fire Protection - Firefighters,0,0,0,0,0,0,0,0
0400000US10,10,Delaware,,2014,1122,Fire Protection - Other ,0,0,0,0,0,0,0,0
0400000US10,10,Delaware,,2014,1140,Corrections,2847,11656963,51,70137,5049,2878,2898,11727100
0400000US10,10,Delaware,,2014,1160,Highways,1493,5414314,1,1426,124,1494,1494,5415740
0400000US10,10,Delaware,,2014,1180,Air Transportation,0,0,0,0,0,0,0,0
0400000US10,10,Delaware,,2014,1200,Water Transport and Terminals       ,273,1118192,0,0,0,273,273,1118192
0400000US10,10,Delaware,,2014,1220,Public Welfare,1519,5448849,124,194645,10684,1584,1643,5643494
0400000US10,10,Delaware,,2014,1240,Health,2047,7796932,168,300291,16984,2150,2215,8097223
0400000US10,10,Delaware,,2014,1260,Hospitals,1323,4611715,112,158818,10470,1386,1435,4770533
0400000US10,10,Delaware,,2014,1280,Social Insurance Administration,322,1065753,22,38598,1658,332,344,1104351
0400000US10,10,Delaware,,2014,1300,Solid Waste Management,118,477726,20,32304,2502,133,138,510030
0400000US10,10,Delaware,,2014,1320,Sewerage,0,0,0,0,0,0,0,0
0400000US10,10,Delaware,,2014,1340,Parks and Recreation,303,780341,27,20281,1473,312,330,800622
0400000US10,10,Delaware,,2014,1360,Housing and Community Development,0,0,0,0,0,0,0,0
0400000US10,10,Delaware,,2014,1380,Natural Resources,434,1707979,50,71744,4601,462,484,1779723
0400000US10,10,Delaware,,2014,1400,Water Supply,0,0,0,0,0,0,0,0
0400000US10,10,Delaware,,2014,1420,Electric Power,0,0,0,0,0,0,0,0
0400000US10,10,Delaware,,2014,1440,Gas Supply,0,0,0,0,0,0,0,0
0400000US10,10,Delaware,,2014,1460,Transit,867,3712467,32,49870,2232,880,899,3762337
0400000US10,10,Delaware,,2014,1480,Education Total ,5958,34483086,6463,7839076,393540,8329,12421,42322162
0400000US10,10,Delaware,,2014,1481,Education - Elementary and Secondary Total ,0,0,0,0,0,0,0,0
0400000US10,10,Delaware,,2014,14811,Education - Elementary and Secondary Instructional             ,0,0,0,0,0,0,0,0
0400000US10,10,Delaware,,2014,14812,Education - Elementary and Secondary Other ,0,0,0,0,0,0,0,0
0400000US10,10,Delaware,,2014,1482,Education - Higher Education Total ,5611,32432664,6441,7812668,392183,7974,12052,40245332
0400000US10,10,Delaware,,2014,14821,Education - Higher Education Instructional,1507,12319531,2884,5325996,153710,2434,4391,17645527
0400000US10,10,Delaware,,2014,14822,Education - Higher Education Other ,4104,20113133,3557,2486672,238473,5540,7661,22599805
0400000US10,10,Delaware,,2014,1483,Education - Other,347,2050422,22,26408,1357,355,369,2076830
0400000US10,10,Delaware,,2014,1500,Libraries                          ,0,0,0,0,0,0,0,0
0400000US10,10,Delaware,,2014,1560,State liquor stores,0,0,0,0,0,0,0,0
0400000US10,10,Delaware,,2014,1580,All other and unallocable,1681,7092085,257,273755,15360,1772,1938,7365840
0400000US12,12,Florida,,2014,1000,Total - All Government Employment Functions,159004,676020796,46153,56391682,3103238,176537,205157,732412478
0400000US12,12,Florida,,2014,1020,Financial Administration,6270,22306492,147,173367,11960,6338,6417,22479859
0400000US12,12,Florida,,2014,1040,Other Government Administration,1973,8740229,244,241915,20469,2088,2217,8982144
0400000US12,12,Florida,,2014,1060,Judicial and Legal,18968,78449299,756,1249134,62524,19321,19724,79698433
0400000US12,12,Florida,,2014,1100,Police Protection Total,4147,16349104,407,513120,22162,4272,4554,16862224
0400000US12,12,Florida,,2014,1101,Police Protection - Persons with Power of Arrest       ,2285,9895221,197,226555,5881,2318,2482,10121776
0400000US12,12,Florida,,2014,1102,Police Protection - Other ,1862,6453883,210,286565,16281,1954,2072,6740448
0400000US12,12,Florida,,2014,1120,Fire Protection Total ,0,0,0,0,0,0,0,0
0400000US12,12,Florida,,2014,1121,Fire Protection - Firefighters,0,0,0,0,0,0,0,0
0400000US12,12,Florida,,2014,1122,Fire Protection - Other ,0,0,0,0,0,0,0,0
0400000US12,12,Florida,,2014,1140,Corrections,23012,72979580,166,146195,10405,23071,23178,73125775
0400000US12,12,Florida,,2014,1160,Highways,6335,27584591,61,39820,2998,6352,6396,27624411
0400000US12,12,Florida,,2014,1180,Air Transportation,0,0,0,0,0,0,0,0
0400000US12,12,Florida,,2014,1200,Water Transport and Terminals       ,0,0,0,0,0,0,0,0
0400000US12,12,Florida,,2014,1220,Public Welfare,8882,28124002,279,305880,21823,9005,9161,28429882
0400000US12,12,Florida,,2014,1240,Health,16881,56656131,934,1981795,98400,17437,17815,58637926
0400000US12,12,Florida,,2014,1260,Hospitals,3865,13142046,63,125329,5354,3895,3928,13267375
0400000US12,12,Florida,,2014,1280,Social Insurance Administration,3081,10099938,162,233032,14440,3163,3243,10332970
0400000US12,12,Florida,,2014,1300,Solid Waste Management,0,0,0,0,0,0,0,0
0400000US12,12,Florida,,2014,1320,Sewerage,0,0,0,0,0,0,0,0
0400000US12,12,Florida,,2014,1340,Parks and Recreation,1211,3032863,267,300902,17533,1310,1478,3333765
0400000US12,12,Florida,,2014,1360,Housing and Community Development,0,0,0,0,0,0,0,0
0400000US12,12,Florida,,2014,1380,Natural Resources,7782,26886276,760,844267,62812,8137,8542,27730543
0400000US12,12,Florida,,2014,1400,Water Supply,0,0,0,0,0,0,0,0
0400000US12,12,Florida,,2014,1420,Electric Power,0,0,0,0,0,0,0,0
0400000US12,12,Florida,,2014,1440,Gas Supply,0,0,0,0,0,0,0,0
0400000US12,12,Florida,,2014,1460,Transit,682,3103273,71,119045,8791,732,753,3222318
0400000US12,12,Florida,,2014,1480,Education Total ,50097,287830798,41478,49670273,2715753,65440,91575,337501071
0400000US12,12,Florida,,2014,1481,Education - Elementary and Secondary Total ,0,0,0,0,0,0,0,0
0400000US12,12,Florida,,2014,14811,Education - Elementary and Secondary Instructional             ,0,0,0,0,0,0,0,0
0400000US12,12,Florida,,2014,14812,Education - Elementary and Secondary Other ,0,0,0,0,0,0,0,0
0400000US12,12,Florida,,2014,1482,Education - Higher Education Total ,47259,277690963,41189,49436609,2703230,62531,88448,327127572
0400000US12,12,Florida,,2014,14821,Education - Higher Education Instructional,13808,137422892,15465,29073122,1210366,20646,29273,166496014
0400000US12,12,Florida,,2014,14822,Education - Higher Education Other ,33451,140268071,25724,20363487,1492864,41885,59175,160631558
0400000US12,12,Florida,,2014,1483,Education - Other,2838,10139835,289,233664,12523,2909,3127,10373499
0400000US12,12,Florida,,2014,1500,Libraries                          ,0,0,0,0,0,0,0,0
0400000US12,12,Florida,,2014,1560,State liquor stores,0,0,0,0,0,0,0,0
0400000US12,12,Florida,,2014,1580,All other and unallocable,5818,20736174,358,447608,27814,5976,6176,21183782
0400000US13,13,Georgia,,2014,1000,Total - All Government Employment Functions,114056,461957092,48124,47104017,2506384,128224,162180,509061109
0400000US13,13,Georgia,,2014,1020,Financial Administration,3153,12012291,121,174057,11581,3219,3274,12186348
0400000US13,13,Georgia,,2014,1040,Other Government Administration,1208,3968898,34,70370,3140,1226,1242,4039268
0400000US13,13,Georgia,,2014,1060,Judicial and Legal,3743,15732730,80,139024,6855,3783,3823,15871754
0400000US13,13,Georgia,,2014,1100,Police Protection Total,2906,10070098,33,45256,3250,2924,2939,10115354
0400000US13,13,Georgia,,2014,1101,Police Protection - Persons with Power of Arrest       ,1724,5912880,9,11932,748,1728,1733,5924812
0400000US13,13,Georgia,,2014,1102,Police Protection - Other ,1182,4157218,24,33324,2502,1196,1206,4190542
0400000US13,13,Georgia,,2014,1120,Fire Protection Total ,0,0,0,0,0,0,0,0
0400000US13,13,Georgia,,2014,1121,Fire Protection - Firefighters,0,0,0,0,0,0,0,0
0400000US13,13,Georgia,,2014,1122,Fire Protection - Other ,0,0,0,0,0,0,0,0
0400000US13,13,Georgia,,2014,1140,Corrections,17022,44343474,515,740164,33526,17211,17537,45083638
0400000US13,13,Georgia,,2014,1160,Highways,4886,14266222,24,10922,990,4892,4910,14277144
0400000US13,13,Georgia,,2014,1180,Air Transportation,2,8426,0,0,0,2,2,8426
0400000US13,13,Georgia,,2014,1200,Water Transport and Terminals       ,983,6943284,0,0,0,983,983,6943284
0400000US13,13,Georgia,,2014,1220,Public Welfare,7030,23432617,20,24275,908,7036,7050,23456892
0400000US13,13,Georgia,,2014,1240,Health,3678,16298169,103,170796,7071,3718,3781,16468965
0400000US13,13,Georgia,,2014,1260,Hospitals,7600,30034695,556,818955,34039,7793,8156,30853650
0400000US13,13,Georgia,,2014,1280,Social Insurance Administration,1692,4323770,82,136276,8486,1740,1774,4460046
0400000US13,13,Georgia,,2014,1300,Solid Waste Management,0,0,0,0,0,0,0,0
0400000US13,13,Georgia,,2014,1320,Sewerage,0,0,0,0,0,0,0,0
0400000US13,13,Georgia,,2014,1340,Parks and Recreation,2791,6996315,857,992086,107330,3397,3648,7988401
0400000US13,13,Georgia,,2014,1360,Housing and Community Development,0,0,0,0,0,0,0,0
0400000US13,13,Georgia,,2014,1380,Natural Resources,4303,14843910,1198,1282530,95950,4845,5501,16126440
0400000US13,13,Georgia,,2014,1400,Water Supply,0,0,0,0,0,0,0,0
0400000US13,13,Georgia,,2014,1420,Electric Power,0,0,0,0,0,0,0,0
0400000US13,13,Georgia,,2014,1440,Gas Supply,0,0,0,0,0,0,0,0
0400000US13,13,Georgia,,2014,1460,Transit,0,0,0,0,0,0,0,0
0400000US13,13,Georgia,,2014,1480,Education Total ,50756,250521791,44419,42366070,2185952,63109,95175,292887861
0400000US13,13,Georgia,,2014,1481,Education - Elementary and Secondary Total ,0,0,0,0,0,0,0,0
0400000US13,13,Georgia,,2014,14811,Education - Elementary and Secondary Instructional             ,0,0,0,0,0,0,0,0
0400000US13,13,Georgia,,2014,14812,Education - Elementary and Secondary Other ,0,0,0,0,0,0,0,0
0400000US13,13,Georgia,,2014,1482,Education - Higher Education Total ,48298,239192340,44291,42104547,2174786,60587,92589,281296887
0400000US13,13,Georgia,,2014,14821,Education - Higher Education Instructional,14825,96941197,17820,25529953,942803,20151,32645,122471150
0400000US13,13,Georgia,,2014,14822,Education - Higher Education Other ,33473,142251143,26471,16574594,1231983,40436,59944,158825737
0400000US13,13,Georgia,,2014,1483,Education - Other,2458,11329451,128,261523,11166,2522,2586,11590974
0400000US13,13,Georgia,,2014,1500,Libraries                          ,0,0,0,0,0,0,0,0
0400000US13,13,Georgia,,2014,1560,State liquor stores,0,0,0,0,0,0,0,0
0400000US13,13,Georgia,,2014,1580,All other and unallocable,2303,8160402,82,133236,7306,2346,2385,8293638
0400000US15,15,Hawaii,,2014,1000,Total - All Government Employment Functions,52434,235981071,20353,20089190,1013800,58409,72787,256070261
0400000US15,15,Hawaii,,2014,1020,Financial Administration,687,2803938,0,0,0,687,687,2803938
0400000US15,15,Hawaii,,2014,1040,Other Government Administration,697,3230897,150,364931,14292,777,847,3595828
0400000US15,15,Hawaii,,2014,1060,Judicial and Legal,2483,11855772,54,120560,2654,2498,2537,11976332
0400000US15,15,Hawaii,,2014,1100,Police Protection Total,0,0,0,0,0,0,0,0
0400000US15,15,Hawaii,,2014,1101,Police Protection - Persons with Power of Arrest       ,0,0,0,0,0,0,0,0
0400000US15,15,Hawaii,,2014,1102,Police Protection - Other ,0,0,0,0,0,0,0,0
0400000US15,15,Hawaii,,2014,1120,Fire Protection Total ,0,0,0,0,0,0,0,0
0400000US15,15,Hawaii,,2014,1121,Fire Protection - Firefighters,0,0,0,0,0,0,0,0
0400000US15,15,Hawaii,,2014,1122,Fire Protection - Other ,0,0,0,0,0,0,0,0
0400000US15,15,Hawaii,,2014,1140,Corrections,2424,11134766,12,54070,884,2429,2436,11188836
0400000US15,15,Hawaii,,2014,1160,Highways,883,4125206,14,10898,1094,889,897,4136104
0400000US15,15,Hawaii,,2014,1180,Air Transportation,989,4124008,6,5010,456,992,995,4129018
0400000US15,15,Hawaii,,2014,1200,Water Transport and Terminals       ,220,898252,0,0,0,220,220,898252
0400000US15,15,Hawaii,,2014,1220,Public Welfare,413,1718060,3,1486,228,414,416,1719546
0400000US15,15,Hawaii,,2014,1240,Health,1965,9462530,47,145328,4136,1988,2012,9607858
0400000US15,15,Hawaii,,2014,1260,Hospitals,4301,22277271,784,2183329,62694,4655,5085,24460600
0400000US15,15,Hawaii,,2014,1280,Social Insurance Administration,241,990570,30,64300,2398,255,271,1054870
0400000US15,15,Hawaii,,2014,1300,Solid Waste Management,0,0,0,0,0,0,0,0
0400000US15,15,Hawaii,,2014,1320,Sewerage,0,0,0,0,0,0,0,0
0400000US15,15,Hawaii,,2014,1340,Parks and Recreation,135,509432,531,115596,7216,176,666,625028
0400000US15,15,Hawaii,,2014,1360,Housing and Community Development,0,0,0,0,0,0,0,0
0400000US15,15,Hawaii,,2014,1380,Natural Resources,810,3600774,4,7754,336,812,814,3608528
0400000US15,15,Hawaii,,2014,1400,Water Supply,0,0,0,0,0,0,0,0
0400000US15,15,Hawaii,,2014,1420,Electric Power,0,0,0,0,0,0,0,0
0400000US15,15,Hawaii,,2014,1440,Gas Supply,0,0,0,0,0,0,0,0
0400000US15,15,Hawaii,,2014,1460,Transit,0,0,0,0,0,0,0,0
0400000US15,15,Hawaii,,2014,1480,Education Total ,32024,141695366,18432,16752654,896232,37337,50456,158448020
0400000US15,15,Hawaii,,2014,1481,Education - Elementary and Secondary Total ,22277,93285906,13049,12327658,669608,26310,35326,105613564
0400000US15,15,Hawaii,,2014,14811,Education - Elementary and Secondary Instructional             ,17138,77217138,11373,10936276,600502,20755,28511,88153414
0400000US15,15,Hawaii,,2014,14812,Education - Elementary and Secondary Other ,5139,16068768,1676,1391382,69106,5555,6815,17460150
0400000US15,15,Hawaii,,2014,1482,Education - Higher Education Total ,9622,47904770,5381,4421134,226464,10901,15003,52325904
0400000US15,15,Hawaii,,2014,14821,Education - Higher Education Instructional,3748,25123870,887,1109182,36668,3955,4635,26233052
0400000US15,15,Hawaii,,2014,14822,Education - Higher Education Other ,5874,22780900,4494,3311952,189796,6946,10368,26092852
0400000US15,15,Hawaii,,2014,1483,Education - Other,125,504690,2,3862,160,126,127,508552
0400000US15,15,Hawaii,,2014,1500,Libraries                          ,448,1661436,245,210690,17904,549,693,1872126
0400000US15,15,Hawaii,,2014,1560,State liquor stores,0,0,0,0,0,0,0,0
0400000US15,15,Hawaii,,2014,1580,All other and unallocable,3714,15892793,41,52584,3276,3731,3755,15945377
0400000US16,16,Idaho,,2014,1000,Total - All Government Employment Functions,19869,92050316,10415,10964171,629092,23423,30284,103014487
0400000US16,16,Idaho,,2014,1020,Financial Administration,1218,5933824,118,208637,15411,1305,1336,6142461
0400000US16,16,Idaho,,2014,1040,Other Government Administration,235,1127972,87,190769,13629,311,322,1318741
0400000US16,16,Idaho,,2014,1060,Judicial and Legal,499,4104676,58,153174,2844,515,557,4257850
0400000US16,16,Idaho,,2014,1100,Police Protection Total,477,2268177,23,34492,1955,488,500,2302669
0400000US16,16,Idaho,,2014,1101,Police Protection - Persons with Power of Arrest       ,269,1460977,0,0,0,269,269,1460977
0400000US16,16,Idaho,,2014,1102,Police Protection - Other ,208,807200,23,34492,1955,219,231,841692
0400000US16,16,Idaho,,2014,1120,Fire Protection Total ,0,0,0,0,0,0,0,0
0400000US16,16,Idaho,,2014,1121,Fire Protection - Firefighters,0,0,0,0,0,0,0,0
0400000US16,16,Idaho,,2014,1122,Fire Protection - Other ,0,0,0,0,0,0,0,0
0400000US16,16,Idaho,,2014,1140,Corrections,2003,8733292,30,70310,3654,2024,2033,8803602
0400000US16,16,Idaho,,2014,1160,Highways,1415,5460778,56,117565,9324,1468,1471,5578343
0400000US16,16,Idaho,,2014,1180,Air Transportation,0,0,0,0,0,0,0,0
0400000US16,16,Idaho,,2014,1200,Water Transport and Terminals       ,0,0,0,0,0,0,0,0
0400000US16,16,Idaho,,2014,1220,Public Welfare,1697,6320516,104,242011,12389,1767,1801,6562527
0400000US16,16,Idaho,,2014,1240,Health,1580,7313094,295,733481,27411,1734,1875,8046575
0400000US16,16,Idaho,,2014,1260,Hospitals,542,1849584,101,166381,11601,608,643,2015965
0400000US16,16,Idaho,,2014,1280,Social Insurance Administration,545,2763330,119,382288,15600,633,664,3145618
0400000US16,16,Idaho,,2014,1300,Solid Waste Management,0,0,0,0,0,0,0,0
0400000US16,16,Idaho,,2014,1320,Sewerage,0,0,0,0,0,0,0,0
0400000US16,16,Idaho,,2014,1340,Parks and Recreation,145,653030,85,103799,7039,185,230,756829
0400000US16,16,Idaho,,2014,1360,Housing and Community Development,0,0,0,0,0,0,0,0
0400000US16,16,Idaho,,2014,1380,Natural Resources,1518,7563287,655,986433,59039,1851,2173,8549720
0400000US16,16,Idaho,,2014,1400,Water Supply,0,0,0,0,0,0,0,0
0400000US16,16,Idaho,,2014,1420,Electric Power,0,0,0,0,0,0,0,0
0400000US16,16,Idaho,,2014,1440,Gas Supply,0,0,0,0,0,0,0,0
0400000US16,16,Idaho,,2014,1460,Transit,0,0,0,0,0,0,0,0
0400000US16,16,Idaho,,2014,1480,Education Total ,6806,31635641,8439,7238381,428675,9228,15245,38874022
0400000US16,16,Idaho,,2014,1481,Education - Elementary and Secondary Total ,0,0,0,0,0,0,0,0
0400000US16,16,Idaho,,2014,14811,Education - Elementary and Secondary Instructional             ,0,0,0,0,0,0,0,0
0400000US16,16,Idaho,,2014,14812,Education - Elementary and Secondary Other ,0,0,0,0,0,0,0,0
0400000US16,16,Idaho,,2014,1482,Education - Higher Education Total ,6456,29642121,8418,7204273,427218,8871,14874,36846394
0400000US16,16,Idaho,,2014,14821,Education - Higher Education Instructional,2339,13536588,3230,4008167,144368,3155,5569,17544755
0400000US16,16,Idaho,,2014,14822,Education - Higher Education Other ,4117,16105533,5188,3196106,282850,5716,9305,19301639
0400000US16,16,Idaho,,2014,1483,Education - Other,350,1993520,21,34108,1457,357,371,2027628
0400000US16,16,Idaho,,2014,1500,Libraries                          ,0,0,0,0,0,0,0,0
0400000US16,16,Idaho,,2014,1560,State liquor stores,166,630026,159,185635,13602,243,325,815661
0400000US16,16,Idaho,,2014,1580,All other and unallocable,1023,5693089,86,150815,6919,1063,1109,5843904
0400000US17,17,Illinois,,2014,1000,Total - All Government Employment Functions,103031,593172123,51710,87519756,3473192,123954,154741,680691879
0400000US17,17,Illinois,,2014,1020,Financial Administration,4717,23944757,317,613968,30312,4899,5034,24558725
0400000US17,17,Illinois,,2014,1040,Other Government Administration,2008,12960788,39,55844,2259,2021,2047,13016632
0400000US17,17,Illinois,,2014,1060,Judicial and Legal,2549,22653078,31,122762,3420,2570,2580,22775840
0400000US17,17,Illinois,,2014,1100,Police Protection Total,3261,21734614,13,30500,722,3266,3274,21765114
0400000US17,17,Illinois,,2014,1101,Police Protection - Persons with Power of Arrest       ,1988,14341208,0,0,0,1988,1988,14341208
0400000US17,17,Illinois,,2014,1102,Police Protection - Other ,1273,7393406,13,30500,722,1278,1286,7423906
0400000US17,17,Illinois,,2014,1120,Fire Protection Total ,0,0,0,0,0,0,0,0
0400000US17,17,Illinois,,2014,1121,Fire Protection - Firefighters,0,0,0,0,0,0,0,0
0400000US17,17,Illinois,,2014,1122,Fire Protection - Other ,0,0,0,0,0,0,0,0
0400000US17,17,Illinois,,2014,1140,Corrections,11809,72866902,0,0,0,11809,11809,72866902
0400000US17,17,Illinois,,2014,1160,Highways,5839,37311951,1526,6756217,171511,6872,7365,44068168
0400000US17,17,Illinois,,2014,1180,Air Transportation,0,0,0,0,0,0,0,0
0400000US17,17,Illinois,,2014,1200,Water Transport and Terminals       ,45,286884,0,0,0,45,45,286884
0400000US17,17,Illinois,,2014,1220,Public Welfare,9314,53510668,34,117482,2726,9330,9348,53628150
0400000US17,17,Illinois,,2014,1240,Health,2342,15554275,18,66686,1324,2350,2360,15620961
0400000US17,17,Illinois,,2014,1260,Hospitals,9602,51634710,607,1616361,41231,9850,10209,53251071
0400000US17,17,Illinois,,2014,1280,Social Insurance Administration,1573,9397355,0,0,0,1573,1573,9397355
0400000US17,17,Illinois,,2014,1300,Solid Waste Management,0,0,0,0,0,0,0,0
0400000US17,17,Illinois,,2014,1320,Sewerage,0,0,0,0,0,0,0,0
0400000US17,17,Illinois,,2014,1340,Parks and Recreation,364,1806952,26,78406,3578,385,390,1885358
0400000US17,17,Illinois,,2014,1360,Housing and Community Development,0,0,0,0,0,0,0,0
0400000US17,17,Illinois,,2014,1380,Natural Resources,2197,11234037,1319,3351096,140372,3043,3516,14585133
0400000US17,17,Illinois,,2014,1400,Water Supply,0,0,0,0,0,0,0,0
0400000US17,17,Illinois,,2014,1420,Electric Power,0,0,0,0,0,0,0,0
0400000US17,17,Illinois,,2014,1440,Gas Supply,0,0,0,0,0,0,0,0
0400000US17,17,Illinois,,2014,1460,Transit,0,0,0,0,0,0,0,0
0400000US17,17,Illinois,,2014,1480,Education Total ,41380,223444331,47580,74257785,3057809,59802,88960,297702116
0400000US17,17,Illinois,,2014,1481,Education - Elementary and Secondary Total ,0,0,0,0,0,0,0,0
0400000US17,17,Illinois,,2014,14811,Education - Elementary and Secondary Instructional             ,0,0,0,0,0,0,0,0
0400000US17,17,Illinois,,2014,14812,Education - Elementary and Secondary Other ,0,0,0,0,0,0,0,0
0400000US17,17,Illinois,,2014,1482,Education - Higher Education Total ,39454,214085781,47557,74208139,3055713,57863,87011,288293920
0400000US17,17,Illinois,,2014,14821,Education - Higher Education Instructional,12806,86279462,17697,35452964,930166,18410,30503,121732426
0400000US17,17,Illinois,,2014,14822,Education - Higher Education Other ,26648,127806319,29860,38755175,2125547,39453,56508,166561494
0400000US17,17,Illinois,,2014,1483,Education - Other,1926,9358550,23,49646,2096,1939,1949,9408196
0400000US17,17,Illinois,,2014,1500,Libraries                          ,0,0,0,0,0,0,0,0
0400000US17,17,Illinois,,2014,1560,State liquor stores,0,0,0,0,0,0,0,0
0400000US17,17,Illinois,,2014,1580,All other and unallocable,6031,34830821,200,452649,17928,6139,6231,35283470
0400000US18,18,Indiana,,2014,1000,Total - All Government Employment Functions,74486,319080345,42117,34496518,2320945,87671,116603,353576863
0400000US18,18,Indiana,,2014,1020,Financial Administration,1789,7489616,18,35130,1649,1798,1807,7524746
0400000US18,18,Indiana,,2014,1040,Other Government Administration,555,2486808,265,590828,39714,780,820,3077636
0400000US18,18,Indiana,,2014,1060,Judicial and Legal,1402,9028592,55,63526,3678,1423,1457,9092118
0400000US18,18,Indiana,,2014,1100,Police Protection Total,1882,8057736,0,0,0,1882,1882,8057736
0400000US18,18,Indiana,,2014,1101,Police Protection - Persons with Power of Arrest       ,1310,6205638,0,0,0,1310,1310,6205638
0400000US18,18,Indiana,,2014,1102,Police Protection - Other ,572,1852098,0,0,0,572,572,1852098
0400000US18,18,Indiana,,2014,1120,Fire Protection Total ,0,0,0,0,0,0,0,0
0400000US18,18,Indiana,,2014,1121,Fire Protection - Firefighters,0,0,0,0,0,0,0,0
0400000US18,18,Indiana,,2014,1122,Fire Protection - Other ,0,0,0,0,0,0,0,0
0400000US18,18,Indiana,,2014,1140,Corrections,6081,16995934,1,1098,90,6082,6082,16997032
0400000US18,18,Indiana,,2014,1160,Highways,3465,12127092,94,183004,10636,3525,3559,12310096
0400000US18,18,Indiana,,2014,1180,Air Transportation,0,0,0,0,0,0,0,0
0400000US18,18,Indiana,,2014,1200,Water Transport and Terminals       ,28,166313,8,5000,80,28,36,171313
0400000US18,18,Indiana,,2014,1220,Public Welfare,5096,15828330,24,29384,2156,5108,5120,15857714
0400000US18,18,Indiana,,2014,1240,Health,1674,6226912,9,20312,708,1678,1683,6247224
0400000US18,18,Indiana,,2014,1260,Hospitals,1878,5648392,29,40618,2112,1889,1907,5689010
0400000US18,18,Indiana,,2014,1280,Social Insurance Administration,1220,3424222,97,102646,8714,1269,1317,3526868
0400000US18,18,Indiana,,2014,1300,Solid Waste Management,0,0,0,0,0,0,0,0
0400000US18,18,Indiana,,2014,1320,Sewerage,0,0,0,0,0,0,0,0
0400000US18,18,Indiana,,2014,1340,Parks and Recreation,132,463490,51,45641,4112,156,183,509131
0400000US18,18,Indiana,,2014,1360,Housing and Community Development,0,0,0,0,0,0,0,0
0400000US18,18,Indiana,,2014,1380,Natural Resources,2136,7837599,276,324263,23383,2272,2412,8161862
0400000US18,18,Indiana,,2014,1400,Water Supply,0,0,0,0,0,0,0,0
0400000US18,18,Indiana,,2014,1420,Electric Power,0,0,0,0,0,0,0,0
0400000US18,18,Indiana,,2014,1440,Gas Supply,0,0,0,0,0,0,0,0
0400000US18,18,Indiana,,2014,1460,Transit,0,0,0,0,0,0,0,0
0400000US18,18,Indiana,,2014,1480,Education Total ,44871,215169175,41020,32930729,2214350,57448,85891,248099904
0400000US18,18,Indiana,,2014,1481,Education - Elementary and Secondary Total ,0,0,0,0,0,0,0,0
0400000US18,18,Indiana,,2014,14811,Education - Elementary and Secondary Instructional             ,0,0,0,0,0,0,0,0
0400000US18,18,Indiana,,2014,14812,Education - Elementary and Secondary Other ,0,0,0,0,0,0,0,0
0400000US18,18,Indiana,,2014,1482,Education - Higher Education Total ,43955,211937957,40882,32845199,2208142,56497,84837,244783156
0400000US18,18,Indiana,,2014,14821,Education - Higher Education Instructional,18983,114398334,11301,17972169,892767,24045,30284,132370503
0400000US18,18,Indiana,,2014,14822,Education - Higher Education Other ,24972,97539623,29581,14873030,1315375,32452,54553,112412653
0400000US18,18,Indiana,,2014,1483,Education - Other,916,3231218,138,85530,6208,951,1054,3316748
0400000US18,18,Indiana,,2014,1500,Libraries                          ,0,0,0,0,0,0,0,0
0400000US18,18,Indiana,,2014,1560,State liquor stores,0,0,0,0,0,0,0,0
0400000US18,18,Indiana,,2014,1580,All other and unallocable,2277,8130134,170,124339,9563,2333,2447,8254473
0400000US19,19,Iowa,,2014,1000,Total - All Government Employment Functions,40373,249639214,28669,24104461,1747310,50242,69042,273743675
0400000US19,19,Iowa,,2014,1020,Financial Administration,1323,7118076,50,120022,5606,1353,1373,7238098
0400000US19,19,Iowa,,2014,1040,Other Government Administration,354,1903070,253,545931,36538,560,607,2449001
0400000US19,19,Iowa,,2014,1060,Judicial and Legal,2220,12358168,95,238421,10917,2282,2315,12596589
0400000US19,19,Iowa,,2014,1100,Police Protection Total,937,5376237,18,18392,899,943,955,5394629
0400000US19,19,Iowa,,2014,1101,Police Protection - Persons with Power of Arrest       ,648,3855200,2,1853,102,649,650,3857053
0400000US19,19,Iowa,,2014,1102,Police Protection - Other ,289,1521037,16,16539,797,294,305,1537576
0400000US19,19,Iowa,,2014,1120,Fire Protection Total ,0,0,0,0,0,0,0,0
0400000US19,19,Iowa,,2014,1121,Fire Protection - Firefighters,0,0,0,0,0,0,0,0
0400000US19,19,Iowa,,2014,1122,Fire Protection - Other ,0,0,0,0,0,0,0,0
0400000US19,19,Iowa,,2014,1140,Corrections,2801,14077797,184,584299,21288,2921,2985,14662096
0400000US19,19,Iowa,,2014,1160,Highways,2184,12213322,294,218829,13691,2261,2478,12432151
0400000US19,19,Iowa,,2014,1180,Air Transportation,0,0,0,0,0,0,0,0
0400000US19,19,Iowa,,2014,1200,Water Transport and Terminals       ,0,0,0,0,0,0,0,0
0400000US19,19,Iowa,,2014,1220,Public Welfare,2622,13194638,46,139554,5281,2651,2668,13334192
0400000US19,19,Iowa,,2014,1240,Health,390,2362353,54,116146,4251,414,444,2478499
0400000US19,19,Iowa,,2014,1260,Hospitals,6844,41284848,4671,3035254,193256,7934,11515,44320102
0400000US19,19,Iowa,,2014,1280,Social Insurance Administration,561,2868253,2,3895,217,562,563,2872148
0400000US19,19,Iowa,,2014,1300,Solid Waste Management,0,0,0,0,0,0,0,0
0400000US19,19,Iowa,,2014,1320,Sewerage,0,0,0,0,0,0,0,0
0400000US19,19,Iowa,,2014,1340,Parks and Recreation,98,568181,11,13842,1523,107,109,582023
0400000US19,19,Iowa,,2014,1360,Housing and Community Development,89,585395,6,15228,629,93,95,600623
0400000US19,19,Iowa,,2014,1380,Natural Resources,1505,8312782,169,248585,15764,1594,1674,8561367
0400000US19,19,Iowa,,2014,1400,Water Supply,0,0,0,0,0,0,0,0
0400000US19,19,Iowa,,2014,1420,Electric Power,0,0,0,0,0,0,0,0
0400000US19,19,Iowa,,2014,1440,Gas Supply,0,0,0,0,0,0,0,0
0400000US19,19,Iowa,,2014,1460,Transit,0,0,0,0,0,0,0,0
0400000US19,19,Iowa,,2014,1480,Education Total ,16075,114551406,22489,18010520,1399437,23981,38564,132561926
0400000US19,19,Iowa,,2014,1481,Education - Elementary and Secondary Total ,0,0,0,0,0,0,0,0
0400000US19,19,Iowa,,2014,14811,Education - Elementary and Secondary Instructional             ,0,0,0,0,0,0,0,0
0400000US19,19,Iowa,,2014,14812,Education - Elementary and Secondary Other ,0,0,0,0,0,0,0,0
0400000US19,19,Iowa,,2014,1482,Education - Higher Education Total ,15084,109000944,22390,17690133,1390799,22941,37474,126691077
0400000US19,19,Iowa,,2014,14821,Education - Higher Education Instructional,3642,37167912,6608,11245287,421813,6025,10250,48413199
0400000US19,19,Iowa,,2014,14822,Education - Higher Education Other ,11442,71833032,15782,6444846,968986,16916,27224,78277878
0400000US19,19,Iowa,,2014,1483,Education - Other,991,5550462,99,320387,8638,1040,1090,5870849
0400000US19,19,Iowa,,2014,1500,Libraries                          ,0,0,0,0,0,0,0,0
0400000US19,19,Iowa,,2014,1560,State liquor stores,0,0,0,0,0,0,0,0
0400000US19,19,Iowa,,2014,1580,All other and unallocable,2370,12864688,327,795543,38013,2586,2697,13660231
0400000US20,20,Kansas,,2014,1000,Total - All Government Employment Functions,44727,202111553,17319,18505024,953553,50184,62046,220616577
0400000US20,20,Kansas,,2014,1020,Financial Administration,1732,6789107,62,69745,3783,1753,1794,6858852
0400000US20,20,Kansas,,2014,1040,Other Government Administration,457,1522598,187,457176,19077,564,644,1979774
0400000US20,20,Kansas,,2014,1060,Judicial and Legal,2062,8864120,119,134996,7469,2104,2181,8999116
0400000US20,20,Kansas,,2014,1100,Police Protection Total,1026,4521781,56,78630,4404,1051,1082,4600411
0400000US20,20,Kansas,,2014,1101,Police Protection - Persons with Power of Arrest       ,268,1412087,22,39326,1935,279,290,1451413
0400000US20,20,Kansas,,2014,1102,Police Protection - Other ,758,3109694,34,39304,2469,772,792,3148998
0400000US20,20,Kansas,,2014,1120,Fire Protection Total ,0,0,0,0,0,0,0,0
0400000US20,20,Kansas,,2014,1121,Fire Protection - Firefighters,0,0,0,0,0,0,0,0
0400000US20,20,Kansas,,2014,1122,Fire Protection - Other ,0,0,0,0,0,0,0,0
0400000US20,20,Kansas,,2014,1140,Corrections,3427,10744792,17,21237,1342,3435,3444,10766029
0400000US20,20,Kansas,,2014,1160,Highways,2781,10812771,122,143634,9356,2834,2903,10956405
0400000US20,20,Kansas,,2014,1180,Air Transportation,0,0,0,0,0,0,0,0
0400000US20,20,Kansas,,2014,1200,Water Transport and Terminals       ,0,0,0,0,0,0,0,0
0400000US20,20,Kansas,,2014,1220,Public Welfare,2902,9998830,51,39363,3889,2924,2953,10038193
0400000US20,20,Kansas,,2014,1240,Health,1008,4157591,25,50442,2001,1019,1033,4208033
0400000US20,20,Kansas,,2014,1260,Hospitals,7761,35083342,1755,4320377,152681,8678,9516,39403719
0400000US20,20,Kansas,,2014,1280,Social Insurance Administration,96,340573,1,204,33,96,97,340777
0400000US20,20,Kansas,,2014,1300,Solid Waste Management,0,0,0,0,0,0,0,0
0400000US20,20,Kansas,,2014,1320,Sewerage,0,0,0,0,0,0,0,0
0400000US20,20,Kansas,,2014,1340,Parks and Recreation,517,1594303,1,436,35,517,518,1594739
0400000US20,20,Kansas,,2014,1360,Housing and Community Development,0,0,0,0,0,0,0,0
0400000US20,20,Kansas,,2014,1380,Natural Resources,757,3172244,97,106031,7237,798,854,3278275
0400000US20,20,Kansas,,2014,1400,Water Supply,0,0,0,0,0,0,0,0
0400000US20,20,Kansas,,2014,1420,Electric Power,0,0,0,0,0,0,0,0
0400000US20,20,Kansas,,2014,1440,Gas Supply,0,0,0,0,0,0,0,0
0400000US20,20,Kansas,,2014,1460,Transit,0,0,0,0,0,0,0,0
0400000US20,20,Kansas,,2014,1480,Education Total ,18031,95596334,14634,12809081,728750,22168,32665,108405415
0400000US20,20,Kansas,,2014,1481,Education - Elementary and Secondary Total ,0,0,0,0,0,0,0,0
0400000US20,20,Kansas,,2014,14811,Education - Elementary and Secondary Instructional             ,0,0,0,0,0,0,0,0
0400000US20,20,Kansas,,2014,14812,Education - Elementary and Secondary Other ,0,0,0,0,0,0,0,0
0400000US20,20,Kansas,,2014,1482,Education - Higher Education Total ,17420,92994254,14555,12704005,724398,21533,31975,105698259
0400000US20,20,Kansas,,2014,14821,Education - Higher Education Instructional,6430,47382527,3802,6351721,240011,7790,10232,53734248
0400000US20,20,Kansas,,2014,14822,Education - Higher Education Other ,10990,45611727,10753,6352284,484387,13743,21743,51964011
0400000US20,20,Kansas,,2014,1483,Education - Other,611,2602080,79,105076,4352,635,690,2707156
0400000US20,20,Kansas,,2014,1500,Libraries                          ,0,0,0,0,0,0,0,0
0400000US20,20,Kansas,,2014,1560,State liquor stores,0,0,0,0,0,0,0,0
0400000US20,20,Kansas,,2014,1580,All other and unallocable,2170,8913167,192,273672,13496,2243,2362,9186839
0400000US21,21,Kentucky,,2014,1000,Total - All Government Employment Functions,74017,311321769,26327,27452465,1796526,84568,100344,338774234
0400000US21,21,Kentucky,,2014,1020,Financial Administration,2568,9848636,33,37807,1437,2576,2601,9886443
0400000US21,21,Kentucky,,2014,1040,Other Government Administration,756,3925005,352,840210,30819,943,1108,4765215
0400000US21,21,Kentucky,,2014,1060,Judicial and Legal,5051,18198971,176,267828,17036,5154,5227,18466799
0400000US21,21,Kentucky,,2014,1100,Police Protection Total,2069,7934007,5,8402,484,2072,2074,7942409
0400000US21,21,Kentucky,,2014,1101,Police Protection - Persons with Power of Arrest       ,1048,3969194,1,1751,102,1049,1049,3970945
0400000US21,21,Kentucky,,2014,1102,Police Protection - Other ,1021,3964813,4,6651,382,1023,1025,3971464
0400000US21,21,Kentucky,,2014,1120,Fire Protection Total ,0,0,0,0,0,0,0,0
0400000US21,21,Kentucky,,2014,1121,Fire Protection - Firefighters,0,0,0,0,0,0,0,0
0400000US21,21,Kentucky,,2014,1122,Fire Protection - Other ,0,0,0,0,0,0,0,0
0400000US21,21,Kentucky,,2014,1140,Corrections,4332,11361261,11,12383,784,4337,4343,11373644
0400000US21,21,Kentucky,,2014,1160,Highways,4441,14479354,17,33873,1344,4449,4458,14513227
0400000US21,21,Kentucky,,2014,1180,Air Transportation,30,122671,1,100,2,30,31,122771
0400000US21,21,Kentucky,,2014,1200,Water Transport and Terminals       ,0,0,0,0,0,0,0,0
0400000US21,21,Kentucky,,2014,1220,Public Welfare,7152,21904726,17,27904,1306,7159,7169,21932630
0400000US21,21,Kentucky,,2014,1240,Health,3006,12290714,69,83866,3640,3026,3075,12374580
0400000US21,21,Kentucky,,2014,1260,Hospitals,5789,25790729,786,1507486,61228,6135,6575,27298215
0400000US21,21,Kentucky,,2014,1280,Social Insurance Administration,1268,3845931,25,41317,1854,1279,1293,3887248
0400000US21,21,Kentucky,,2014,1300,Solid Waste Management,0,0,0,0,0,0,0,0
0400000US21,21,Kentucky,,2014,1320,Sewerage,0,0,0,0,0,0,0,0
0400000US21,21,Kentucky,,2014,1340,Parks and Recreation,1058,2600968,7,4895,425,1061,1065,2605863
0400000US21,21,Kentucky,,2014,1360,Housing and Community Development,0,0,0,0,0,0,0,0
0400000US21,21,Kentucky,,2014,1380,Natural Resources,2681,9664891,133,231439,15920,2772,2814,9896330
0400000US21,21,Kentucky,,2014,1400,Water Supply,0,0,0,0,0,0,0,0
0400000US21,21,Kentucky,,2014,1420,Electric Power,0,0,0,0,0,0,0,0
0400000US21,21,Kentucky,,2014,1440,Gas Supply,0,0,0,0,0,0,0,0
0400000US21,21,Kentucky,,2014,1460,Transit,0,0,0,0,0,0,0,0
0400000US21,21,Kentucky,,2014,1480,Education Total ,31124,159630655,24453,24246470,1654969,40852,55577,183877125
0400000US21,21,Kentucky,,2014,1481,Education - Elementary and Secondary Total ,0,0,0,0,0,0,0,0
0400000US21,21,Kentucky,,2014,14811,Education - Elementary and Secondary Instructional             ,0,0,0,0,0,0,0,0
0400000US21,21,Kentucky,,2014,14812,Education - Elementary and Secondary Other ,0,0,0,0,0,0,0,0
0400000US21,21,Kentucky,,2014,1482,Education - Higher Education Total ,29024,150757915,24082,23948344,1640561,38664,53106,174706259
0400000US21,21,Kentucky,,2014,14821,Education - Higher Education Instructional,9273,72201169,7708,11833526,511089,12275,16981,84034695
0400000US21,21,Kentucky,,2014,14822,Education - Higher Education Other ,19751,78556746,16374,12114818,1129472,26389,36125,90671564
0400000US21,21,Kentucky,,2014,1483,Education - Other,2100,8872740,371,298126,14408,2188,2471,9170866
0400000US21,21,Kentucky,,2014,1500,Libraries                          ,0,0,0,0,0,0,0,0
0400000US21,21,Kentucky,,2014,1560,State liquor stores,0,0,0,0,0,0,0,0
0400000US21,21,Kentucky,,2014,1580,All other and unallocable,2692,9723250,242,108485,5278,2723,2934,9831735
0400000US22,22,Louisiana,,2014,1000,Total - All Government Employment Functions,69592,308485365,20804,20753962,1284305,77005,90396,329239327
0400000US22,22,Louisiana,,2014,1020,Financial Administration,1909,8336759,131,199401,12706,1981,2040,8536160
0400000US22,22,Louisiana,,2014,1040,Other Government Administration,2061,10191400,545,708962,41025,2291,2606,10900362
0400000US22,22,Louisiana,,2014,1060,Judicial and Legal,1628,7461257,51,64705,2793,1643,1679,7525962
0400000US22,22,Louisiana,,2014,1100,Police Protection Total,1656,8944682,61,140710,5859,1689,1717,9085392
0400000US22,22,Louisiana,,2014,1101,Police Protection - Persons with Power of Arrest       ,1116,6784503,30,78609,3023,1133,1146,6863112
0400000US22,22,Louisiana,,2014,1102,Police Protection - Other ,540,2160179,31,62101,2836,556,571,2222280
0400000US22,22,Louisiana,,2014,1120,Fire Protection Total ,0,0,0,0,0,0,0,0
0400000US22,22,Louisiana,,2014,1121,Fire Protection - Firefighters,0,0,0,0,0,0,0,0
0400000US22,22,Louisiana,,2014,1122,Fire Protection - Other ,0,0,0,0,0,0,0,0
0400000US22,22,Louisiana,,2014,1140,Corrections,5847,23621721,85,146444,8412,5895,5932,23768165
0400000US22,22,Louisiana,,2014,1160,Highways,4409,18529141,41,58589,3012,4426,4450,18587730
0400000US22,22,Louisiana,,2014,1180,Air Transportation,0,0,0,0,0,0,0,0
0400000US22,22,Louisiana,,2014,1200,Water Transport and Terminals       ,281,1532693,0,0,0,281,281,1532693
0400000US22,22,Louisiana,,2014,1220,Public Welfare,5475,20279334,168,234925,14732,5559,5643,20514259
0400000US22,22,Louisiana,,2014,1240,Health,3646,17381301,139,348310,12957,3719,3785,17729611
0400000US22,22,Louisiana,,2014,1260,Hospitals,9245,36032402,999,1478581,98194,9800,10244,37510983
0400000US22,22,Louisiana,,2014,1280,Social Insurance Administration,1117,4177084,41,40136,3437,1136,1158,4217220
0400000US22,22,Louisiana,,2014,1300,Solid Waste Management,0,0,0,0,0,0,0,0
0400000US22,22,Louisiana,,2014,1320,Sewerage,0,0,0,0,0,0,0,0
0400000US22,22,Louisiana,,2014,1340,Parks and Recreation,880,2985331,260,299268,25081,1022,1140,3284599
0400000US22,22,Louisiana,,2014,1360,Housing and Community Development,0,0,0,0,0,0,0,0
0400000US22,22,Louisiana,,2014,1380,Natural Resources,3771,16933910,749,753407,53588,4088,4520,17687317
0400000US22,22,Louisiana,,2014,1400,Water Supply,0,0,0,0,0,0,0,0
0400000US22,22,Louisiana,,2014,1420,Electric Power,0,0,0,0,0,0,0,0
0400000US22,22,Louisiana,,2014,1440,Gas Supply,0,0,0,0,0,0,0,0
0400000US22,22,Louisiana,,2014,1460,Transit,0,0,0,0,0,0,0,0
0400000US22,22,Louisiana,,2014,1480,Education Total ,25166,120921006,17373,16104020,992914,30919,42539,137025026
0400000US22,22,Louisiana,,2014,1481,Education - Elementary and Secondary Total ,524,2290570,71,79243,4046,547,595,2369813
0400000US22,22,Louisiana,,2014,14811,Education - Elementary and Secondary Instructional             ,453,1937398,57,42233,2310,466,510,1979631
0400000US22,22,Louisiana,,2014,14812,Education - Elementary and Secondary Other ,71,353172,14,37010,1736,81,85,390182
0400000US22,22,Louisiana,,2014,1482,Education - Higher Education Total ,22200,107963791,16758,15200865,954589,27734,38958,123164656
0400000US22,22,Louisiana,,2014,14821,Education - Higher Education Instructional,7252,51920991,5518,8166279,362799,9350,12770,60087270
0400000US22,22,Louisiana,,2014,14822,Education - Higher Education Other ,14948,56042800,11240,7034586,591790,18384,26188,63077386
0400000US22,22,Louisiana,,2014,1483,Education - Other,2442,10666645,544,823912,34279,2638,2986,11490557
0400000US22,22,Louisiana,,2014,1500,Libraries                          ,0,0,0,0,0,0,0,0
0400000US22,22,Louisiana,,2014,1560,State liquor stores,0,0,0,0,0,0,0,0
0400000US22,22,Louisiana,,2014,1580,All other and unallocable,2501,11157344,161,176504,9595,2556,2662,11333848
0400000US23,23,Maine,,2014,1000,Total - All Government Employment Functions,18723,80137447,8269,8098946,420669,21111,26992,88236393
0400000US23,23,Maine,,2014,1020,Financial Administration,1254,4833400,47,182883,6547,1290,1301,5016283
0400000US23,23,Maine,,2014,1040,Other Government Administration,282,1369486,194,531165,22778,410,476,1900651
0400000US23,23,Maine,,2014,1060,Judicial and Legal,665,3245102,125,271308,11228,729,790,3516410
0400000US23,23,Maine,,2014,1100,Police Protection Total,516,2680681,3,6278,301,518,519,2686959
0400000US23,23,Maine,,2014,1101,Police Protection - Persons with Power of Arrest       ,306,1829890,0,0,0,306,306,1829890
0400000US23,23,Maine,,2014,1102,Police Protection - Other ,210,850791,3,6278,301,212,213,857069
0400000US23,23,Maine,,2014,1120,Fire Protection Total ,0,0,0,0,0,0,0,0
0400000US23,23,Maine,,2014,1121,Fire Protection - Firefighters,0,0,0,0,0,0,0,0
0400000US23,23,Maine,,2014,1122,Fire Protection - Other ,0,0,0,0,0,0,0,0
0400000US23,23,Maine,,2014,1140,Corrections,1166,4392412,23,45962,2163,1179,1189,4438374
0400000US23,23,Maine,,2014,1160,Highways,1977,8204745,130,217204,11871,2044,2107,8421949
0400000US23,23,Maine,,2014,1180,Air Transportation,0,0,0,0,0,0,0,0
0400000US23,23,Maine,,2014,1200,Water Transport and Terminals       ,66,262991,21,45570,2974,83,87,308561
0400000US23,23,Maine,,2014,1220,Public Welfare,2800,10129272,43,90945,4181,2824,2843,10220217
0400000US23,23,Maine,,2014,1240,Health,987,4265015,19,72395,2346,1000,1006,4337410
0400000US23,23,Maine,,2014,1260,Hospitals,430,1776887,42,104016,4418,455,472,1880903
0400000US23,23,Maine,,2014,1280,Social Insurance Administration,394,1433363,2,7287,319,396,396,1440650
0400000US23,23,Maine,,2014,1300,Solid Waste Management,0,0,0,0,0,0,0,0
0400000US23,23,Maine,,2014,1320,Sewerage,0,0,0,0,0,0,0,0
0400000US23,23,Maine,,2014,1340,Parks and Recreation,172,613659,1,2403,91,173,173,616062
0400000US23,23,Maine,,2014,1360,Housing and Community Development,0,0,0,0,0,0,0,0
0400000US23,23,Maine,,2014,1380,Natural Resources,1079,4673401,192,311275,10527,1138,1271,4984676
0400000US23,23,Maine,,2014,1400,Water Supply,0,0,0,0,0,0,0,0
0400000US23,23,Maine,,2014,1420,Electric Power,0,0,0,0,0,0,0,0
0400000US23,23,Maine,,2014,1440,Gas Supply,0,0,0,0,0,0,0,0
0400000US23,23,Maine,,2014,1460,Transit,0,0,0,0,0,0,0,0
0400000US23,23,Maine,,2014,1480,Education Total ,5687,26552012,7341,5927881,330273,7566,13028,32479893
0400000US23,23,Maine,,2014,1481,Education - Elementary and Secondary Total ,19,65964,39,44637,3279,37,58,110601
0400000US23,23,Maine,,2014,14811,Education - Elementary and Secondary Instructional             ,13,53429,18,24855,1654,22,31,78284
0400000US23,23,Maine,,2014,14812,Education - Elementary and Secondary Other ,6,12535,21,19782,1625,15,27,32317
0400000US23,23,Maine,,2014,1482,Education - Higher Education Total ,5437,25537840,7302,5883244,326994,7298,12739,31421084
0400000US23,23,Maine,,2014,14821,Education - Higher Education Instructional,1719,10394486,2537,3363707,114652,2376,4256,13758193
0400000US23,23,Maine,,2014,14822,Education - Higher Education Other ,3718,15143354,4765,2519537,212342,4922,8483,17662891
0400000US23,23,Maine,,2014,1483,Education - Other,231,948208,0,0,0,231,231,948208
0400000US23,23,Maine,,2014,1500,Libraries                          ,0,0,0,0,0,0,0,0
0400000US23,23,Maine,,2014,1560,State liquor stores,12,43088,0,0,0,12,12,43088
0400000US23,23,Maine,,2014,1580,All other and unallocable,1236,5661933,86,282374,10652,1294,1322,5944307
0400000US24,24,Maryland,,2014,1000,Total - All Government Employment Functions,77843,390090146,13725,39449014,1548348,86595,91568,429539160
0400000US24,24,Maryland,,2014,1020,Financial Administration,2844,13305879,168,409659,21402,2967,3012,13715538
0400000US24,24,Maryland,,2014,1040,Other Government Administration,1454,8106841,264,536675,16343,1546,1718,8643516
0400000US24,24,Maryland,,2014,1060,Judicial and Legal,4788,27180927,489,1300554,70430,5186,5277,28481481
0400000US24,24,Maryland,,2014,1100,Police Protection Total,2272,12678465,0,0,0,2272,2272,12678465
0400000US24,24,Maryland,,2014,1101,Police Protection - Persons with Power of Arrest       ,1492,9197831,0,0,0,1492,1492,9197831
0400000US24,24,Maryland,,2014,1102,Police Protection - Other ,780,3480634,0,0,0,780,780,3480634
0400000US24,24,Maryland,,2014,1120,Fire Protection Total ,0,0,0,0,0,0,0,0
0400000US24,24,Maryland,,2014,1121,Fire Protection - Firefighters,0,0,0,0,0,0,0,0
0400000US24,24,Maryland,,2014,1122,Fire Protection - Other ,0,0,0,0,0,0,0,0
0400000US24,24,Maryland,,2014,1140,Corrections,12167,55589982,503,1213934,69325,12559,12670,56803916
0400000US24,24,Maryland,,2014,1160,Highways,4528,22635808,0,0,0,4528,4528,22635808
0400000US24,24,Maryland,,2014,1180,Air Transportation,469,2567761,0,0,0,469,469,2567761
0400000US24,24,Maryland,,2014,1200,Water Transport and Terminals       ,270,1659169,0,0,0,270,270,1659169
0400000US24,24,Maryland,,2014,1220,Public Welfare,6469,26769994,245,573626,32397,6654,6714,27343620
0400000US24,24,Maryland,,2014,1240,Health,5432,25713934,875,1826373,107394,6039,6307,27540307
0400000US24,24,Maryland,,2014,1260,Hospitals,3446,15569037,479,923044,39137,3666,3925,16492081
0400000US24,24,Maryland,,2014,1280,Social Insurance Administration,891,4065462,178,482993,25633,1036,1069,4548455
0400000US24,24,Maryland,,2014,1300,Solid Waste Management,0,0,0,0,0,0,0,0
0400000US24,24,Maryland,,2014,1320,Sewerage,0,0,0,0,0,0,0,0
0400000US24,24,Maryland,,2014,1340,Parks and Recreation,363,1643173,111,162679,9705,418,474,1805852
0400000US24,24,Maryland,,2014,1360,Housing and Community Development,0,0,0,0,0,0,0,0
0400000US24,24,Maryland,,2014,1380,Natural Resources,1809,9753163,318,766173,38323,2025,2127,10519336
0400000US24,24,Maryland,,2014,1400,Water Supply,0,0,0,0,0,0,0,0
0400000US24,24,Maryland,,2014,1420,Electric Power,0,0,0,0,0,0,0,0
0400000US24,24,Maryland,,2014,1440,Gas Supply,0,0,0,0,0,0,0,0
0400000US24,24,Maryland,,2014,1460,Transit,715,4147924,0,0,0,715,715,4147924
0400000US24,24,Maryland,,2014,1480,Education Total ,23913,129173500,9537,29827369,1053321,29865,33450,159000869
0400000US24,24,Maryland,,2014,1481,Education - Elementary and Secondary Total ,0,0,0,0,0,0,0,0
0400000US24,24,Maryland,,2014,14811,Education - Elementary and Secondary Instructional             ,0,0,0,0,0,0,0,0
0400000US24,24,Maryland,,2014,14812,Education - Elementary and Secondary Other ,0,0,0,0,0,0,0,0
0400000US24,24,Maryland,,2014,1482,Education - Higher Education Total ,22133,120180295,9158,28640510,1007984,27829,31291,148820805
0400000US24,24,Maryland,,2014,14821,Education - Higher Education Instructional,7039,53912214,4459,22649576,634700,10626,11498,76561790
0400000US24,24,Maryland,,2014,14822,Education - Higher Education Other ,15094,66268081,4699,5990934,373284,17203,19793,72259015
0400000US24,24,Maryland,,2014,1483,Education - Other,1780,8993205,379,1186859,45337,2036,2159,10180064
0400000US24,24,Maryland,,2014,1500,Libraries                          ,0,0,0,0,0,0,0,0
0400000US24,24,Maryland,,2014,1560,State liquor stores,0,0,0,0,0,0,0,0
0400000US24,24,Maryland,,2014,1580,All other and unallocable,6013,29529127,558,1425935,64938,6380,6571,30955062
0400000US25,25,Massachusetts,,2014,1000,Total - All Government Employment Functions,89262,500159676,35052,48594483,1739722,99670,124314,548754159
0400000US25,25,Massachusetts,,2014,1020,Financial Administration,3853,21658443,247,868941,12502,3929,4100,22527384
0400000US25,25,Massachusetts,,2014,1040,Other Government Administration,1983,9824254,81,228663,4487,2011,2064,10052917
0400000US25,25,Massachusetts,,2014,1060,Judicial and Legal,9028,51711281,363,1258112,18992,9141,9391,52969393
0400000US25,25,Massachusetts,,2014,1100,Police Protection Total,2916,25825870,29,102839,1969,2926,2945,25928709
0400000US25,25,Massachusetts,,2014,1101,Police Protection - Persons with Power of Arrest       ,2127,21049038,1,2192,49,2127,2128,21051230
0400000US25,25,Massachusetts,,2014,1102,Police Protection - Other ,789,4776832,28,100647,1920,799,817,4877479
0400000US25,25,Massachusetts,,2014,1120,Fire Protection Total ,0,0,0,0,0,0,0,0
0400000US25,25,Massachusetts,,2014,1121,Fire Protection - Firefighters,0,0,0,0,0,0,0,0
0400000US25,25,Massachusetts,,2014,1122,Fire Protection - Other ,0,0,0,0,0,0,0,0
0400000US25,25,Massachusetts,,2014,1140,Corrections,12253,63876777,147,404650,6921,12295,12400,64281427
0400000US25,25,Massachusetts,,2014,1160,Highways,3116,18175936,46,188912,3718,3138,3162,18364848
0400000US25,25,Massachusetts,,2014,1180,Air Transportation,1012,7049095,0,0,0,1012,1012,7049095
0400000US25,25,Massachusetts,,2014,1200,Water Transport and Terminals       ,160,1109676,0,0,0,160,160,1109676
0400000US25,25,Massachusetts,,2014,1220,Public Welfare,6773,36636236,429,1458082,23863,6917,7202,38094318
0400000US25,25,Massachusetts,,2014,1240,Health,6646,34359082,857,2432277,65930,7043,7503,36791359
0400000US25,25,Massachusetts,,2014,1260,Hospitals,5825,25515728,789,2317860,65043,6200,6614,27833588
0400000US25,25,Massachusetts,,2014,1280,Social Insurance Administration,1536,7759167,44,193947,3078,1555,1580,7953114
0400000US25,25,Massachusetts,,2014,1300,Solid Waste Management,0,0,0,0,0,0,0,0
0400000US25,25,Massachusetts,,2014,1320,Sewerage,811,5349440,36,236026,3268,831,847,5585466
0400000US25,25,Massachusetts,,2014,1340,Parks and Recreation,904,4591253,149,170706,10726,966,1053,4761959
0400000US25,25,Massachusetts,,2014,1360,Housing and Community Development,0,0,0,0,0,0,0,0
0400000US25,25,Massachusetts,,2014,1380,Natural Resources,1112,6948344,116,417733,6096,1147,1228,7366077
0400000US25,25,Massachusetts,,2014,1400,Water Supply,486,2925029,18,39300,775,491,504,2964329
0400000US25,25,Massachusetts,,2014,1420,Electric Power,0,0,0,0,0,0,0,0
0400000US25,25,Massachusetts,,2014,1440,Gas Supply,0,0,0,0,0,0,0,0
0400000US25,25,Massachusetts,,2014,1460,Transit,0,0,0,0,0,0,0,0
0400000US25,25,Massachusetts,,2014,1480,Education Total ,26611,150596818,31467,37318968,1494865,35568,58078,187915786
0400000US25,25,Massachusetts,,2014,1481,Education - Elementary and Secondary Total ,2276,10520352,121,156719,7429,2321,2397,10677071
0400000US25,25,Massachusetts,,2014,14811,Education - Elementary and Secondary Instructional             ,1810,8551869,7,10850,266,1812,1817,8562719
0400000US25,25,Massachusetts,,2014,14812,Education - Elementary and Secondary Other ,466,1968483,114,145869,7163,509,580,2114352
0400000US25,25,Massachusetts,,2014,1482,Education - Higher Education Total ,23237,133329684,31242,36849194,1482544,32120,54479,170178878
0400000US25,25,Massachusetts,,2014,14821,Education - Higher Education Instructional,6744,48019647,12425,23293259,754286,11279,19169,71312906
0400000US25,25,Massachusetts,,2014,14822,Education - Higher Education Other ,16493,85310037,18817,13555935,728258,20841,35310,98865972
0400000US25,25,Massachusetts,,2014,1483,Education - Other,1098,6746782,104,313055,4892,1127,1202,7059837
0400000US25,25,Massachusetts,,2014,1500,Libraries                          ,0,0,0,0,0,0,0,0
0400000US25,25,Massachusetts,,2014,1560,State liquor stores,0,0,0,0,0,0,0,0
0400000US25,25,Massachusetts,,2014,1580,All other and unallocable,4237,26247247,234,957467,17489,4340,4471,27204714
0400000US26,26,Michigan,,2014,1000,Total - All Government Employment Functions,113140,636557653,71749,113554934,5103262,142057,184889,750112587
0400000US26,26,Michigan,,2014,1020,Financial Administration,3885,21895857,407,1694277,59234,4220,4292,23590134
0400000US26,26,Michigan,,2014,1040,Other Government Administration,1461,8175732,30,115561,3550,1481,1491,8291293
0400000US26,26,Michigan,,2014,1060,Judicial and Legal,1438,9953041,54,201768,6428,1474,1492,10154809
0400000US26,26,Michigan,,2014,1100,Police Protection Total,2597,13709144,36,67419,3468,2617,2633,13776563
0400000US26,26,Michigan,,2014,1101,Police Protection - Persons with Power of Arrest       ,1927,10744797,0,0,0,1927,1927,10744797
0400000US26,26,Michigan,,2014,1102,Police Protection - Other ,670,2964347,36,67419,3468,690,706,3031766
0400000US26,26,Michigan,,2014,1120,Fire Protection Total ,0,0,0,0,0,0,0,0
0400000US26,26,Michigan,,2014,1121,Fire Protection - Firefighters,0,0,0,0,0,0,0,0
0400000US26,26,Michigan,,2014,1122,Fire Protection - Other ,0,0,0,0,0,0,0,0
0400000US26,26,Michigan,,2014,1140,Corrections,12407,61923390,166,770733,22987,12537,12573,62694123
0400000US26,26,Michigan,,2014,1160,Highways,2384,12938583,350,1051261,49483,2664,2734,13989844
0400000US26,26,Michigan,,2014,1180,Air Transportation,0,0,0,0,0,0,0,0
0400000US26,26,Michigan,,2014,1200,Water Transport and Terminals       ,0,0,0,0,0,0,0,0
0400000US26,26,Michigan,,2014,1220,Public Welfare,11737,53916639,78,264873,10728,11797,11815,54181512
0400000US26,26,Michigan,,2014,1240,Health,4795,22786510,892,3613305,105532,5392,5687,26399815
0400000US26,26,Michigan,,2014,1260,Hospitals,11910,63010449,5869,24126030,739860,16090,17779,87136479
0400000US26,26,Michigan,,2014,1280,Social Insurance Administration,754,3859890,61,221922,10637,814,815,4081812
0400000US26,26,Michigan,,2014,1300,Solid Waste Management,0,0,0,0,0,0,0,0
0400000US26,26,Michigan,,2014,1320,Sewerage,0,0,0,0,0,0,0,0
0400000US26,26,Michigan,,2014,1340,Parks and Recreation,158,808739,74,235649,9074,209,232,1044388
0400000US26,26,Michigan,,2014,1360,Housing and Community Development,275,1572896,42,105154,5361,305,317,1678050
0400000US26,26,Michigan,,2014,1380,Natural Resources,2926,14751915,513,1021742,54730,3236,3439,15773657
0400000US26,26,Michigan,,2014,1400,Water Supply,0,0,0,0,0,0,0,0
0400000US26,26,Michigan,,2014,1420,Electric Power,0,0,0,0,0,0,0,0
0400000US26,26,Michigan,,2014,1440,Gas Supply,0,0,0,0,0,0,0,0
0400000US26,26,Michigan,,2014,1460,Transit,0,0,0,0,0,0,0,0
0400000US26,26,Michigan,,2014,1480,Education Total ,52623,328110189,62572,78538193,3951867,75033,115195,406648382
0400000US26,26,Michigan,,2014,1481,Education - Elementary and Secondary Total ,0,0,0,0,0,0,0,0
0400000US26,26,Michigan,,2014,14811,Education - Elementary and Secondary Instructional             ,0,0,0,0,0,0,0,0
0400000US26,26,Michigan,,2014,14812,Education - Elementary and Secondary Other ,0,0,0,0,0,0,0,0
0400000US26,26,Michigan,,2014,1482,Education - Higher Education Total ,52078,324918675,62482,78180481,3937839,74408,114560,403099156
0400000US26,26,Michigan,,2014,14821,Education - Higher Education Instructional,16576,153416727,13102,37760316,1362232,24303,29678,191177043
0400000US26,26,Michigan,,2014,14822,Education - Higher Education Other ,35502,171501948,49380,40420165,2575607,50105,84882,211922113
0400000US26,26,Michigan,,2014,1483,Education - Other,545,3191514,90,357712,14028,625,635,3549226
0400000US26,26,Michigan,,2014,1500,Libraries                          ,0,0,0,0,0,0,0,0
0400000US26,26,Michigan,,2014,1560,State liquor stores,0,0,0,0,0,0,0,0
0400000US26,26,Michigan,,2014,1580,All other and unallocable,3790,19144679,605,1527047,70323,4188,4395,20671726
0400000US27,27,Minnesota,,2014,1000,Total - All Government Employment Functions,68042,380786579,35533,50989790,2510032,82223,103575,431776369
0400000US27,27,Minnesota,,2014,1020,Financial Administration,4713,27723630,143,463960,20272,4827,4856,28187590
0400000US27,27,Minnesota,,2014,1040,Other Government Administration,946,5572027,178,393755,18070,1049,1124,5965782
0400000US27,27,Minnesota,,2014,1060,Judicial and Legal,3388,18003870,474,1584889,61359,3735,3862,19588759
0400000US27,27,Minnesota,,2014,1100,Police Protection Total,903,4471265,30,62474,3124,921,933,4533739
0400000US27,27,Minnesota,,2014,1101,Police Protection - Persons with Power of Arrest       ,509,2941621,0,0,0,509,509,2941621
0400000US27,27,Minnesota,,2014,1102,Police Protection - Other ,394,1529644,30,62474,3124,412,424,1592118
0400000US27,27,Minnesota,,2014,1120,Fire Protection Total ,0,0,0,0,0,0,0,0
0400000US27,27,Minnesota,,2014,1121,Fire Protection - Firefighters,0,0,0,0,0,0,0,0
0400000US27,27,Minnesota,,2014,1122,Fire Protection - Other ,0,0,0,0,0,0,0,0
0400000US27,27,Minnesota,,2014,1140,Corrections,4036,18574319,153,534628,25320,4179,4189,19108947
0400000US27,27,Minnesota,,2014,1160,Highways,4459,22254437,213,321198,16953,4555,4672,22575635
0400000US27,27,Minnesota,,2014,1180,Air Transportation,0,0,0,0,0,0,0,0
0400000US27,27,Minnesota,,2014,1200,Water Transport and Terminals       ,0,0,0,0,0,0,0,0
0400000US27,27,Minnesota,,2014,1220,Public Welfare,1585,7697892,1385,3695242,267390,3096,2970,11393134
0400000US27,27,Minnesota,,2014,1240,Health,2940,15403251,2276,1873319,72234,3348,5216,17276570
0400000US27,27,Minnesota,,2014,1260,Hospitals,3263,16350815,1361,4258277,224949,4534,4624,20609092
0400000US27,27,Minnesota,,2014,1280,Social Insurance Administration,990,4586478,71,194501,7984,1036,1061,4780979
0400000US27,27,Minnesota,,2014,1300,Solid Waste Management,0,0,0,0,0,0,0,0
0400000US27,27,Minnesota,,2014,1320,Sewerage,621,4037382,15,46282,1297,628,636,4083664
0400000US27,27,Minnesota,,2014,1340,Parks and Recreation,523,2553506,145,187459,11103,585,668,2740965
0400000US27,27,Minnesota,,2014,1360,Housing and Community Development,0,0,0,0,0,0,0,0
0400000US27,27,Minnesota,,2014,1380,Natural Resources,2698,13784535,688,1230707,70479,3096,3386,15015242
0400000US27,27,Minnesota,,2014,1400,Water Supply,0,0,0,0,0,0,0,0
0400000US27,27,Minnesota,,2014,1420,Electric Power,0,0,0,0,0,0,0,0
0400000US27,27,Minnesota,,2014,1440,Gas Supply,0,0,0,0,0,0,0,0
0400000US27,27,Minnesota,,2014,1460,Transit,2551,13552859,439,1109151,48245,2824,2990,14662010
0400000US27,27,Minnesota,,2014,1480,Education Total ,31354,190345246,27776,34637467,1643207,40637,59130,224982713
0400000US27,27,Minnesota,,2014,1481,Education - Elementary and Secondary Total ,0,0,0,0,0,0,0,0
0400000US27,27,Minnesota,,2014,14811,Education - Elementary and Secondary Instructional             ,0,0,0,0,0,0,0,0
0400000US27,27,Minnesota,,2014,14812,Education - Elementary and Secondary Other ,0,0,0,0,0,0,0,0
0400000US27,27,Minnesota,,2014,1482,Education - Higher Education Total ,27988,171747727,26522,32315199,1540428,36689,54510,204062926
0400000US27,27,Minnesota,,2014,14821,Education - Higher Education Instructional,11500,77192123,10729,16909886,607569,14930,22229,94102009
0400000US27,27,Minnesota,,2014,14822,Education - Higher Education Other ,16488,94555604,15793,15405313,932859,21759,32281,109960917
0400000US27,27,Minnesota,,2014,1483,Education - Other,3366,18597519,1254,2322268,102779,3948,4620,20919787
0400000US27,27,Minnesota,,2014,1500,Libraries                          ,0,0,0,0,0,0,0,0
0400000US27,27,Minnesota,,2014,1560,State liquor stores,0,0,0,0,0,0,0,0
0400000US27,27,Minnesota,,2014,1580,All other and unallocable,3072,15875067,186,396481,18046,3173,3258,16271548
0400000US28,28,Mississippi,,2014,1000,Total - All Government Employment Functions,52512,199380629,13944,13893403,909232,57725,66456,213274032
0400000US28,28,Mississippi,,2014,1020,Financial Administration,1418,5304846,59,141394,6762,1457,1477,5446240
0400000US28,28,Mississippi,,2014,1040,Other Government Administration,511,2096896,8,21286,695,515,519,2118182
0400000US28,28,Mississippi,,2014,1060,Judicial and Legal,636,3602486,2,3720,117,637,638,3606206
0400000US28,28,Mississippi,,2014,1100,Police Protection Total,1201,4036694,2,3743,149,1202,1203,4040437
0400000US28,28,Mississippi,,2014,1101,Police Protection - Persons with Power of Arrest       ,632,2336650,0,0,0,632,632,2336650
0400000US28,28,Mississippi,,2014,1102,Police Protection - Other ,569,1700044,2,3743,149,570,571,1703787
0400000US28,28,Mississippi,,2014,1120,Fire Protection Total ,0,0,0,0,0,0,0,0
0400000US28,28,Mississippi,,2014,1121,Fire Protection - Firefighters,0,0,0,0,0,0,0,0
0400000US28,28,Mississippi,,2014,1122,Fire Protection - Other ,0,0,0,0,0,0,0,0
0400000US28,28,Mississippi,,2014,1140,Corrections,3232,8262397,14,28572,2160,3244,3246,8290969
0400000US28,28,Mississippi,,2014,1160,Highways,3289,9916813,9,17109,1064,3295,3298,9933922
0400000US28,28,Mississippi,,2014,1180,Air Transportation,0,0,0,0,0,0,0,0
0400000US28,28,Mississippi,,2014,1200,Water Transport and Terminals       ,41,232128,1,1000,38,41,42,233128
0400000US28,28,Mississippi,,2014,1220,Public Welfare,4454,14523044,52,84293,5936,4488,4506,14607337
0400000US28,28,Mississippi,,2014,1240,Health,3225,10743315,79,56832,2394,3239,3304,10800147
0400000US28,28,Mississippi,,2014,1260,Hospitals,10740,37164041,1597,2175654,109294,11357,12337,39339695
0400000US28,28,Mississippi,,2014,1280,Social Insurance Administration,605,2038737,193,438138,31790,785,798,2476875
0400000US28,28,Mississippi,,2014,1300,Solid Waste Management,0,0,0,0,0,0,0,0
0400000US28,28,Mississippi,,2014,1320,Sewerage,0,0,0,0,0,0,0,0
0400000US28,28,Mississippi,,2014,1340,Parks and Recreation,324,851721,52,33815,3803,347,376,885536
0400000US28,28,Mississippi,,2014,1360,Housing and Community Development,0,0,0,0,0,0,0,0
0400000US28,28,Mississippi,,2014,1380,Natural Resources,2762,8955132,738,659406,47334,3033,3500,9614538
0400000US28,28,Mississippi,,2014,1400,Water Supply,54,148205,2,2474,205,55,56,150679
0400000US28,28,Mississippi,,2014,1420,Electric Power,0,0,0,0,0,0,0,0
0400000US28,28,Mississippi,,2014,1440,Gas Supply,0,0,0,0,0,0,0,0
0400000US28,28,Mississippi,,2014,1460,Transit,0,0,0,0,0,0,0,0
0400000US28,28,Mississippi,,2014,1480,Education Total ,17167,81691771,11013,10038362,684148,21102,28180,91730133
0400000US28,28,Mississippi,,2014,1481,Education - Elementary and Secondary Total ,0,0,0,0,0,0,0,0
0400000US28,28,Mississippi,,2014,14811,Education - Elementary and Secondary Instructional             ,0,0,0,0,0,0,0,0
0400000US28,28,Mississippi,,2014,14812,Education - Elementary and Secondary Other ,0,0,0,0,0,0,0,0
0400000US28,28,Mississippi,,2014,1482,Education - Higher Education Total ,15722,76981908,10985,9996017,681827,19644,26707,86977925
0400000US28,28,Mississippi,,2014,14821,Education - Higher Education Instructional,5909,31857431,1512,2014533,91169,6429,7421,33871964
0400000US28,28,Mississippi,,2014,14822,Education - Higher Education Other ,9813,45124477,9473,7981484,590658,13215,19286,53105961
0400000US28,28,Mississippi,,2014,1483,Education - Other,1445,4709863,28,42345,2321,1458,1473,4752208
0400000US28,28,Mississippi,,2014,1500,Libraries                          ,0,0,0,0,0,0,0,0
0400000US28,28,Mississippi,,2014,1560,State liquor stores,87,217143,0,0,0,87,87,217143
0400000US28,28,Mississippi,,2014,1580,All other and unallocable,2766,9595260,123,187605,13343,2841,2889,9782865
0400000US29,29,Missouri,,2014,1000,Total - All Government Employment Functions,78298,294591342,29622,26123721,1656905,87666,107920,320715063
0400000US29,29,Missouri,,2014,1020,Financial Administration,2819,10362426,149,199528,14120,2899,2968,10561954
0400000US29,29,Missouri,,2014,1040,Other Government Administration,720,2573468,305,725004,35198,919,1025,3298472
0400000US29,29,Missouri,,2014,1060,Judicial and Legal,4029,15760802,352,486128,37594,4241,4381,16246930
0400000US29,29,Missouri,,2014,1100,Police Protection Total,2417,10152744,126,125418,13782,2495,2543,10278162
0400000US29,29,Missouri,,2014,1101,Police Protection - Persons with Power of Arrest       ,1399,6808682,0,0,0,1399,1399,6808682
0400000US29,29,Missouri,,2014,1102,Police Protection - Other ,1018,3344062,126,125418,13782,1096,1144,3469480
0400000US29,29,Missouri,,2014,1120,Fire Protection Total ,0,0,0,0,0,0,0,0
0400000US29,29,Missouri,,2014,1121,Fire Protection - Firefighters,0,0,0,0,0,0,0,0
0400000US29,29,Missouri,,2014,1122,Fire Protection - Other ,0,0,0,0,0,0,0,0
0400000US29,29,Missouri,,2014,1140,Corrections,12224,33023680,153,152323,11499,12289,12377,33176003
0400000US29,29,Missouri,,2014,1160,Highways,5541,18207726,0,0,0,5541,5541,18207726
0400000US29,29,Missouri,,2014,1180,Air Transportation,0,0,0,0,0,0,0,0
0400000US29,29,Missouri,,2014,1200,Water Transport and Terminals       ,0,0,0,0,0,0,0,0
0400000US29,29,Missouri,,2014,1220,Public Welfare,6879,19737576,236,230927,13723,6956,7115,19968503
0400000US29,29,Missouri,,2014,1240,Health,2783,9692936,181,241969,11630,2848,2964,9934905
0400000US29,29,Missouri,,2014,1260,Hospitals,10059,33087422,1243,1760725,96470,10604,11302,34848147
0400000US29,29,Missouri,,2014,1280,Social Insurance Administration,539,1610520,57,31306,1984,550,596,1641826
0400000US29,29,Missouri,,2014,1300,Solid Waste Management,0,0,0,0,0,0,0,0
0400000US29,29,Missouri,,2014,1320,Sewerage,0,0,0,0,0,0,0,0
0400000US29,29,Missouri,,2014,1340,Parks and Recreation,476,1467530,446,55298,5042,504,922,1522828
0400000US29,29,Missouri,,2014,1360,Housing and Community Development,0,0,0,0,0,0,0,0
0400000US29,29,Missouri,,2014,1380,Natural Resources,1921,7051756,495,482083,48608,2195,2416,7533839
0400000US29,29,Missouri,,2014,1400,Water Supply,0,0,0,0,0,0,0,0
0400000US29,29,Missouri,,2014,1420,Electric Power,0,0,0,0,0,0,0,0
0400000US29,29,Missouri,,2014,1440,Gas Supply,0,0,0,0,0,0,0,0
0400000US29,29,Missouri,,2014,1460,Transit,0,0,0,0,0,0,0,0
0400000US29,29,Missouri,,2014,1480,Education Total ,24137,118720517,25610,21367257,1350008,31776,49747,140087774
0400000US29,29,Missouri,,2014,1481,Education - Elementary and Secondary Total ,0,0,0,0,0,0,0,0
0400000US29,29,Missouri,,2014,14811,Education - Elementary and Secondary Instructional             ,0,0,0,0,0,0,0,0
0400000US29,29,Missouri,,2014,14812,Education - Elementary and Secondary Other ,0,0,0,0,0,0,0,0
0400000US29,29,Missouri,,2014,1482,Education - Higher Education Total ,23153,115186665,24621,19625287,1243686,30192,47774,134811952
0400000US29,29,Missouri,,2014,14821,Education - Higher Education Instructional,8520,57617966,8397,10629534,507284,11389,16917,68247500
0400000US29,29,Missouri,,2014,14822,Education - Higher Education Other ,14633,57568699,16224,8995753,736402,18803,30857,66564452
0400000US29,29,Missouri,,2014,1483,Education - Other,984,3533852,989,1741970,106322,1584,1973,5275822
0400000US29,29,Missouri,,2014,1500,Libraries                          ,0,0,0,0,0,0,0,0
0400000US29,29,Missouri,,2014,1560,State liquor stores,0,0,0,0,0,0,0,0
0400000US29,29,Missouri,,2014,1580,All other and unallocable,3754,13142239,269,265755,17247,3849,4023,13407994
0400000US30,30,Montana,,2014,1000,Total - All Government Employment Functions,16877,72980103,10196,11867808,680230,20721,27073,84847911
0400000US30,30,Montana,,2014,1020,Financial Administration,988,3951496,80,157875,9191,1041,1068,4109371
0400000US30,30,Montana,,2014,1040,Other Government Administration,358,1752809,93,120107,6518,394,451,1872916
0400000US30,30,Montana,,2014,1060,Judicial and Legal,679,3221904,78,169313,8641,728,757,3391217
0400000US30,30,Montana,,2014,1100,Police Protection Total,469,2212549,27,56762,2979,487,496,2269311
0400000US30,30,Montana,,2014,1101,Police Protection - Persons with Power of Arrest       ,229,1142638,3,12788,509,232,232,1155426
0400000US30,30,Montana,,2014,1102,Police Protection - Other ,240,1069911,24,43974,2470,255,264,1113885
0400000US30,30,Montana,,2014,1120,Fire Protection Total ,0,0,0,0,0,0,0,0
0400000US30,30,Montana,,2014,1121,Fire Protection - Firefighters,0,0,0,0,0,0,0,0
0400000US30,30,Montana,,2014,1122,Fire Protection - Other ,0,0,0,0,0,0,0,0
0400000US30,30,Montana,,2014,1140,Corrections,1175,4319053,87,192543,11083,1238,1262,4511596
0400000US30,30,Montana,,2014,1160,Highways,2029,9232010,167,310494,16366,2121,2196,9542504
0400000US30,30,Montana,,2014,1180,Air Transportation,0,0,0,0,0,0,0,0
0400000US30,30,Montana,,2014,1200,Water Transport and Terminals       ,0,0,0,0,0,0,0,0
0400000US30,30,Montana,,2014,1220,Public Welfare,1590,5900522,225,577871,31700,1769,1815,6478393
0400000US30,30,Montana,,2014,1240,Health,815,3369897,103,245577,11470,880,918,3615474
0400000US30,30,Montana,,2014,1260,Hospitals,507,1882626,259,421593,25338,650,766,2304219
0400000US30,30,Montana,,2014,1280,Social Insurance Administration,650,2877347,75,157784,8545,699,725,3035131
0400000US30,30,Montana,,2014,1300,Solid Waste Management,0,0,0,0,0,0,0,0
0400000US30,30,Montana,,2014,1320,Sewerage,0,0,0,0,0,0,0,0
0400000US30,30,Montana,,2014,1340,Parks and Recreation,59,233147,30,45853,2546,73,89,279000
0400000US30,30,Montana,,2014,1360,Housing and Community Development,0,0,0,0,0,0,0,0
0400000US30,30,Montana,,2014,1380,Natural Resources,1358,5708318,356,576092,32421,1540,1714,6284410
0400000US30,30,Montana,,2014,1400,Water Supply,0,0,0,0,0,0,0,0
0400000US30,30,Montana,,2014,1420,Electric Power,0,0,0,0,0,0,0,0
0400000US30,30,Montana,,2014,1440,Gas Supply,0,0,0,0,0,0,0,0
0400000US30,30,Montana,,2014,1460,Transit,0,0,0,0,0,0,0,0
0400000US30,30,Montana,,2014,1480,Education Total ,5086,23170956,8478,8498010,498740,7904,13564,31668966
0400000US30,30,Montana,,2014,1481,Education - Elementary and Secondary Total ,0,0,0,0,0,0,0,0
0400000US30,30,Montana,,2014,14811,Education - Elementary and Secondary Instructional             ,0,0,0,0,0,0,0,0
0400000US30,30,Montana,,2014,14812,Education - Elementary and Secondary Other ,0,0,0,0,0,0,0,0
0400000US30,30,Montana,,2014,1482,Education - Higher Education Total ,4783,21834645,8336,8246631,485497,7525,13119,30081276
0400000US30,30,Montana,,2014,14821,Education - Higher Education Instructional,1375,8931869,1555,2752434,115164,2025,2930,11684303
0400000US30,30,Montana,,2014,14822,Education - Higher Education Other ,3408,12902776,6781,5494197,370333,5500,10189,18396973
0400000US30,30,Montana,,2014,1483,Education - Other,303,1336311,142,251379,13243,379,445,1587690
0400000US30,30,Montana,,2014,1500,Libraries                          ,0,0,0,0,0,0,0,0
0400000US30,30,Montana,,2014,1560,State liquor stores,27,104109,6,9258,554,30,33,113367
0400000US30,30,Montana,,2014,1580,All other and unallocable,1087,5043360,132,328676,14138,1167,1219,5372036
0400000US31,31,Nebraska,,2014,1000,Total - All Government Employment Functions,26733,112087322,10188,11878105,949778,32101,36921,123965427
0400000US31,31,Nebraska,,2014,1020,Financial Administration,783,3093448,16,19552,1072,789,799,3113000
0400000US31,31,Nebraska,,2014,1040,Other Government Administration,273,1054650,94,108316,7100,312,367,1162966
0400000US31,31,Nebraska,,2014,1060,Judicial and Legal,733,3595151,41,42578,2705,748,774,3637729
0400000US31,31,Nebraska,,2014,1100,Police Protection Total,831,4125661,13,26445,1931,842,844,4152106
0400000US31,31,Nebraska,,2014,1101,Police Protection - Persons with Power of Arrest       ,528,3057738,0,0,0,528,528,3057738
0400000US31,31,Nebraska,,2014,1102,Police Protection - Other ,303,1067923,13,26445,1931,314,316,1094368
0400000US31,31,Nebraska,,2014,1120,Fire Protection Total ,0,0,0,0,0,0,0,0
0400000US31,31,Nebraska,,2014,1121,Fire Protection - Firefighters,0,0,0,0,0,0,0,0
0400000US31,31,Nebraska,,2014,1122,Fire Protection - Other ,0,0,0,0,0,0,0,0
0400000US31,31,Nebraska,,2014,1140,Corrections,2894,10274866,71,98352,6339,2930,2965,10373218
0400000US31,31,Nebraska,,2014,1160,Highways,2049,7955391,8,22101,833,2054,2057,7977492
0400000US31,31,Nebraska,,2014,1180,Air Transportation,21,94267,0,0,0,21,21,94267
0400000US31,31,Nebraska,,2014,1200,Water Transport and Terminals       ,0,0,0,0,0,0,0,0
0400000US31,31,Nebraska,,2014,1220,Public Welfare,2328,7054199,249,334988,21031,2447,2577,7389187
0400000US31,31,Nebraska,,2014,1240,Health,635,2669168,15,22628,1576,644,650,2691796
0400000US31,31,Nebraska,,2014,1260,Hospitals,3122,12190391,741,1867199,115041,3772,3863,14057590
0400000US31,31,Nebraska,,2014,1280,Social Insurance Administration,211,853750,4,5906,391,213,215,859656
0400000US31,31,Nebraska,,2014,1300,Solid Waste Management,0,0,0,0,0,0,0,0
0400000US31,31,Nebraska,,2014,1320,Sewerage,0,0,0,0,0,0,0,0
0400000US31,31,Nebraska,,2014,1340,Parks and Recreation,205,723978,159,131562,13365,281,364,855540
0400000US31,31,Nebraska,,2014,1360,Housing and Community Development,0,0,0,0,0,0,0,0
0400000US31,31,Nebraska,,2014,1380,Natural Resources,1533,5815094,750,1619410,111024,2161,2283,7434504
0400000US31,31,Nebraska,,2014,1400,Water Supply,0,0,0,0,0,0,0,0
0400000US31,31,Nebraska,,2014,1420,Electric Power,0,0,0,0,0,0,0,0
0400000US31,31,Nebraska,,2014,1440,Gas Supply,0,0,0,0,0,0,0,0
0400000US31,31,Nebraska,,2014,1460,Transit,0,0,0,0,0,0,0,0
0400000US31,31,Nebraska,,2014,1480,Education Total ,9295,45383521,7897,7474074,661426,13034,17192,52857595
0400000US31,31,Nebraska,,2014,1481,Education - Elementary and Secondary Total ,0,0,0,0,0,0,0,0
0400000US31,31,Nebraska,,2014,14811,Education - Elementary and Secondary Instructional             ,0,0,0,0,0,0,0,0
0400000US31,31,Nebraska,,2014,14812,Education - Elementary and Secondary Other ,0,0,0,0,0,0,0,0
0400000US31,31,Nebraska,,2014,1482,Education - Higher Education Total ,8771,43096509,7876,7425979,659034,12495,16647,50522488
0400000US31,31,Nebraska,,2014,14821,Education - Higher Education Instructional,2771,19708679,1125,2143306,99296,3332,3896,21851985
0400000US31,31,Nebraska,,2014,14822,Education - Higher Education Other ,6000,23387830,6751,5282673,559738,9163,12751,28670503
0400000US31,31,Nebraska,,2014,1483,Education - Other,524,2287012,21,48095,2392,539,545,2335107
0400000US31,31,Nebraska,,2014,1500,Libraries                          ,0,0,0,0,0,0,0,0
0400000US31,31,Nebraska,,2014,1560,State liquor stores,0,0,0,0,0,0,0,0
0400000US31,31,Nebraska,,2014,1580,All other and unallocable,1820,7203787,130,104994,5944,1853,1950,7308781
0400000US32,32,Nevada,,2014,1000,Total - All Government Employment Functions,24524,119577340,9711,10979190,480642,27236,34235,130556530
0400000US32,32,Nevada,,2014,1020,Financial Administration,1388,5187798,7,15529,332,1391,1395,5203327
0400000US32,32,Nevada,,2014,1040,Other Government Administration,950,4393988,20,25976,1219,957,970,4419964
0400000US32,32,Nevada,,2014,1060,Judicial and Legal,741,4977077,12,26997,400,743,753,5004074
0400000US32,32,Nevada,,2014,1100,Police Protection Total,838,5093692,6,8800,622,842,844,5102492
0400000US32,32,Nevada,,2014,1101,Police Protection - Persons with Power of Arrest       ,480,3536327,6,8800,622,484,486,3545127
0400000US32,32,Nevada,,2014,1102,Police Protection - Other ,358,1557365,0,0,0,358,358,1557365
0400000US32,32,Nevada,,2014,1120,Fire Protection Total ,0,0,0,0,0,0,0,0
0400000US32,32,Nevada,,2014,1121,Fire Protection - Firefighters,0,0,0,0,0,0,0,0
0400000US32,32,Nevada,,2014,1122,Fire Protection - Other ,0,0,0,0,0,0,0,0
0400000US32,32,Nevada,,2014,1140,Corrections,3566,15172309,37,136237,2137,3578,3603,15308546
0400000US32,32,Nevada,,2014,1160,Highways,1725,7426497,3,4790,199,1726,1728,7431287
0400000US32,32,Nevada,,2014,1180,Air Transportation,0,0,0,0,0,0,0,0
0400000US32,32,Nevada,,2014,1200,Water Transport and Terminals       ,0,0,0,0,0,0,0,0
0400000US32,32,Nevada,,2014,1220,Public Welfare,2064,7393469,10,20440,748,2068,2074,7413909
0400000US32,32,Nevada,,2014,1240,Health,1349,5910044,23,65868,1444,1357,1372,5975912
0400000US32,32,Nevada,,2014,1260,Hospitals,1307,5920296,46,124591,2378,1320,1353,6044887
0400000US32,32,Nevada,,2014,1280,Social Insurance Administration,560,1989837,0,0,0,560,560,1989837
0400000US32,32,Nevada,,2014,1300,Solid Waste Management,0,0,0,0,0,0,0,0
0400000US32,32,Nevada,,2014,1320,Sewerage,0,0,0,0,0,0,0,0
0400000US32,32,Nevada,,2014,1340,Parks and Recreation,169,638356,7,12770,416,171,176,651126
0400000US32,32,Nevada,,2014,1360,Housing and Community Development,0,0,0,0,0,0,0,0
0400000US32,32,Nevada,,2014,1380,Natural Resources,851,3955411,104,141387,7673,894,955,4096798
0400000US32,32,Nevada,,2014,1400,Water Supply,16,105086,0,0,0,16,16,105086
0400000US32,32,Nevada,,2014,1420,Electric Power,16,105086,0,0,0,16,16,105086
0400000US32,32,Nevada,,2014,1440,Gas Supply,0,0,0,0,0,0,0,0
0400000US32,32,Nevada,,2014,1460,Transit,0,0,0,0,0,0,0,0
0400000US32,32,Nevada,,2014,1480,Education Total ,6910,41452182,9383,10291644,459164,9503,16293,51743826
0400000US32,32,Nevada,,2014,1481,Education - Elementary and Secondary Total ,0,0,0,0,0,0,0,0
0400000US32,32,Nevada,,2014,14811,Education - Elementary and Secondary Instructional             ,0,0,0,0,0,0,0,0
0400000US32,32,Nevada,,2014,14812,Education - Elementary and Secondary Other ,0,0,0,0,0,0,0,0
0400000US32,32,Nevada,,2014,1482,Education - Higher Education Total ,6770,40769599,9382,10289193,459117,9363,16152,51058792
0400000US32,32,Nevada,,2014,14821,Education - Higher Education Instructional,1969,16592032,4158,5782111,217765,3199,6127,22374143
0400000US32,32,Nevada,,2014,14822,Education - Higher Education Other ,4801,24177567,5224,4507082,241352,6164,10025,28684649
0400000US32,32,Nevada,,2014,1483,Education - Other,140,682583,1,2451,47,140,141,685034
0400000US32,32,Nevada,,2014,1500,Libraries                          ,0,0,0,0,0,0,0,0
0400000US32,32,Nevada,,2014,1560,State liquor stores,0,0,0,0,0,0,0,0
0400000US32,32,Nevada,,2014,1580,All other and unallocable,2074,9856212,53,104161,3910,2094,2127,9960373
0400000US33,33,New Hampshire,,2014,1000,Total - All Government Employment Functions,14689,73362845,11170,13345887,663105,18693,25859,86708732
0400000US33,33,New Hampshire,,2014,1020,Financial Administration,738,3499445,70,86442,5238,770,808,3585887
0400000US33,33,New Hampshire,,2014,1040,Other Government Administration,313,1441999,451,275688,16064,409,764,1717687
0400000US33,33,New Hampshire,,2014,1060,Judicial and Legal,655,3270120,252,547979,18078,764,907,3818099
0400000US33,33,New Hampshire,,2014,1100,Police Protection Total,482,2581211,47,74940,3798,505,529,2656151
0400000US33,33,New Hampshire,,2014,1101,Police Protection - Persons with Power of Arrest       ,322,1935908,0,0,0,322,322,1935908
0400000US33,33,New Hampshire,,2014,1102,Police Protection - Other ,160,645303,47,74940,3798,183,207,720243
0400000US33,33,New Hampshire,,2014,1120,Fire Protection Total ,0,0,0,0,0,0,0,0
0400000US33,33,New Hampshire,,2014,1121,Fire Protection - Firefighters,0,0,0,0,0,0,0,0
0400000US33,33,New Hampshire,,2014,1122,Fire Protection - Other ,0,0,0,0,0,0,0,0
0400000US33,33,New Hampshire,,2014,1140,Corrections,1011,4930599,76,153233,9878,1071,1087,5083832
0400000US33,33,New Hampshire,,2014,1160,Highways,1486,6612207,193,286568,18312,1596,1679,6898775
0400000US33,33,New Hampshire,,2014,1180,Air Transportation,28,123832,18,38974,2553,42,46,162806
0400000US33,33,New Hampshire,,2014,1200,Water Transport and Terminals       ,11,52848,9,6765,536,14,20,59613
0400000US33,33,New Hampshire,,2014,1220,Public Welfare,1791,7370291,140,262793,15459,1884,1931,7633084
0400000US33,33,New Hampshire,,2014,1240,Health,765,3669819,46,74437,4038,789,811,3744256
0400000US33,33,New Hampshire,,2014,1260,Hospitals,527,2187652,83,105159,7287,571,610,2292811
0400000US33,33,New Hampshire,,2014,1280,Social Insurance Administration,268,1024774,47,72724,4373,294,315,1097498
0400000US33,33,New Hampshire,,2014,1300,Solid Waste Management,0,0,0,0,0,0,0,0
0400000US33,33,New Hampshire,,2014,1320,Sewerage,0,0,0,0,0,0,0,0
0400000US33,33,New Hampshire,,2014,1340,Parks and Recreation,143,550945,314,295443,24074,288,457,846388
0400000US33,33,New Hampshire,,2014,1360,Housing and Community Development,0,0,0,0,0,0,0,0
0400000US33,33,New Hampshire,,2014,1380,Natural Resources,332,1595470,58,61764,3501,354,390,1657234
0400000US33,33,New Hampshire,,2014,1400,Water Supply,22,97774,6,15221,618,26,28,112995
0400000US33,33,New Hampshire,,2014,1420,Electric Power,0,0,0,0,0,0,0,0
0400000US33,33,New Hampshire,,2014,1440,Gas Supply,0,0,0,0,0,0,0,0
0400000US33,33,New Hampshire,,2014,1460,Transit,0,0,0,0,0,0,0,0
0400000US33,33,New Hampshire,,2014,1480,Education Total ,4579,27584285,8268,9887607,450111,7296,12847,37471892
0400000US33,33,New Hampshire,,2014,1481,Education - Elementary and Secondary Total ,0,0,0,0,0,0,0,0
0400000US33,33,New Hampshire,,2014,14811,Education - Elementary and Secondary Instructional             ,0,0,0,0,0,0,0,0
0400000US33,33,New Hampshire,,2014,14812,Education - Elementary and Secondary Other ,0,0,0,0,0,0,0,0
0400000US33,33,New Hampshire,,2014,1482,Education - Higher Education Total ,4291,26277708,8242,9835981,447536,6992,12533,36113689
0400000US33,33,New Hampshire,,2014,14821,Education - Higher Education Instructional,1490,12140612,2228,4945893,142458,2351,3718,17086505
0400000US33,33,New Hampshire,,2014,14822,Education - Higher Education Other ,2801,14137096,6014,4890088,305078,4641,8815,19027184
0400000US33,33,New Hampshire,,2014,1483,Education - Other,288,1306577,26,51626,2575,304,314,1358203
0400000US33,33,New Hampshire,,2014,1500,Libraries                          ,0,0,0,0,0,0,0,0
0400000US33,33,New Hampshire,,2014,1560,State liquor stores,292,1126423,655,614637,51223,601,947,1741060
0400000US33,33,New Hampshire,,2014,1580,All other and unallocable,1246,5643151,437,485513,27964,1419,1683,6128664
0400000US34,34,New Jersey,,2014,1000,Total - All Government Employment Functions,130261,798630097,30454,49974555,2156333,143707,160715,848604652
0400000US34,34,New Jersey,,2014,1020,Financial Administration,5168,27536337,305,626928,32519,5378,5473,28163265
0400000US34,34,New Jersey,,2014,1040,Other Government Administration,1135,6935150,44,81843,4017,1161,1179,7016993
0400000US34,34,New Jersey,,2014,1060,Judicial and Legal,12782,79331676,186,352824,15507,12882,12968,79684500
0400000US34,34,New Jersey,,2014,1100,Police Protection Total,3926,28386105,49,107971,3461,3948,3975,28494076
0400000US34,34,New Jersey,,2014,1101,Police Protection - Persons with Power of Arrest       ,2503,21878474,0,0,0,2503,2503,21878474
0400000US34,34,New Jersey,,2014,1102,Police Protection - Other ,1423,6507631,49,107971,3461,1445,1472,6615602
0400000US34,34,New Jersey,,2014,1120,Fire Protection Total ,0,0,0,0,0,0,0,0
0400000US34,34,New Jersey,,2014,1121,Fire Protection - Firefighters,0,0,0,0,0,0,0,0
0400000US34,34,New Jersey,,2014,1122,Fire Protection - Other ,0,0,0,0,0,0,0,0
0400000US34,34,New Jersey,,2014,1140,Corrections,8784,52798339,15,35721,1096,8791,8799,52834060
0400000US34,34,New Jersey,,2014,1160,Highways,5340,32248189,642,865683,68480,5729,5982,33113872
0400000US34,34,New Jersey,,2014,1180,Air Transportation,0,0,0,0,0,0,0,0
0400000US34,34,New Jersey,,2014,1200,Water Transport and Terminals       ,95,536902,2,3255,217,96,97,540157
0400000US34,34,New Jersey,,2014,1220,Public Welfare,8670,49453451,155,279233,12454,8750,8825,49732684
0400000US34,34,New Jersey,,2014,1240,Health,3817,22672441,750,2090702,31748,4010,4567,24763143
0400000US34,34,New Jersey,,2014,1260,Hospitals,15495,74764842,2267,4513514,214014,16869,17762,79278356
0400000US34,34,New Jersey,,2014,1280,Social Insurance Administration,1548,7976761,200,481709,21038,1684,1748,8458470
0400000US34,34,New Jersey,,2014,1300,Solid Waste Management,484,3513668,18,28230,1738,495,502,3541898
0400000US34,34,New Jersey,,2014,1320,Sewerage,0,0,0,0,0,0,0,0
0400000US34,34,New Jersey,,2014,1340,Parks and Recreation,820,4315510,485,466304,25575,978,1305,4781814
0400000US34,34,New Jersey,,2014,1360,Housing and Community Development,0,0,0,0,0,0,0,0
0400000US34,34,New Jersey,,2014,1380,Natural Resources,1736,10600190,340,515156,24042,1886,2076,11115346
0400000US34,34,New Jersey,,2014,1400,Water Supply,110,590484,0,0,0,110,110,590484
0400000US34,34,New Jersey,,2014,1420,Electric Power,0,0,0,0,0,0,0,0
0400000US34,34,New Jersey,,2014,1440,Gas Supply,0,0,0,0,0,0,0,0
0400000US34,34,New Jersey,,2014,1460,Transit,10713,61722833,792,1271560,64477,11077,11505,62994393
0400000US34,34,New Jersey,,2014,1480,Education Total ,43885,299025579,23983,37806142,1615185,53975,67868,336831721
0400000US34,34,New Jersey,,2014,1481,Education - Elementary and Secondary Total ,14000,92336265,3689,6433719,335350,16131,17689,98769984
0400000US34,34,New Jersey,,2014,14811,Education - Elementary and Secondary Instructional             ,9988,75010409,875,1863229,71033,10441,10863,76873638
0400000US34,34,New Jersey,,2014,14812,Education - Elementary and Secondary Other ,4012,17325856,2814,4570490,264317,5690,6826,21896346
0400000US34,34,New Jersey,,2014,1482,Education - Higher Education Total ,27519,192001102,19833,30368608,1232165,35170,47352,222369710
0400000US34,34,New Jersey,,2014,14821,Education - Higher Education Instructional,7850,85704098,6418,13490572,252378,9431,14268,99194670
0400000US34,34,New Jersey,,2014,14822,Education - Higher Education Other ,19669,106297004,13415,16878036,979787,25739,33084,123175040
0400000US34,34,New Jersey,,2014,1483,Education - Other,2366,14688212,461,1003815,47670,2674,2827,15692027
0400000US34,34,New Jersey,,2014,1500,Libraries                          ,0,0,0,0,0,0,0,0
0400000US34,34,New Jersey,,2014,1560,State liquor stores,0,0,0,0,0,0,0,0
0400000US34,34,New Jersey,,2014,1580,All other and unallocable,5753,36221640,221,447780,20765,5888,5974,36669420
0400000US35,35,New Mexico,,2014,1000,Total - All Government Employment Functions,41263,181903803,13697,17428339,857305,46114,54960,199332142
0400000US35,35,New Mexico,,2014,1020,Financial Administration,1102,4774833,5,14019,733,1107,1107,4788852
0400000US35,35,New Mexico,,2014,1040,Other Government Administration,207,1049548,6,16339,925,212,213,1065887
0400000US35,35,New Mexico,,2014,1060,Judicial and Legal,3223,13794769,63,103897,3993,3246,3286,13898666
0400000US35,35,New Mexico,,2014,1100,Police Protection Total,526,2210433,0,0,0,526,526,2210433
0400000US35,35,New Mexico,,2014,1101,Police Protection - Persons with Power of Arrest       ,526,2210433,0,0,0,526,526,2210433
0400000US35,35,New Mexico,,2014,1102,Police Protection - Other ,0,0,0,0,0,0,0,0
0400000US35,35,New Mexico,,2014,1120,Fire Protection Total ,0,0,0,0,0,0,0,0
0400000US35,35,New Mexico,,2014,1121,Fire Protection - Firefighters,0,0,0,0,0,0,0,0
0400000US35,35,New Mexico,,2014,1122,Fire Protection - Other ,0,0,0,0,0,0,0,0
0400000US35,35,New Mexico,,2014,1140,Corrections,3719,12839423,30,71397,4021,3742,3749,12910820
0400000US35,35,New Mexico,,2014,1160,Highways,2144,7611649,0,0,0,2144,2144,7611649
0400000US35,35,New Mexico,,2014,1180,Air Transportation,6,26614,0,0,0,6,6,26614
0400000US35,35,New Mexico,,2014,1200,Water Transport and Terminals       ,0,0,0,0,0,0,0,0
0400000US35,35,New Mexico,,2014,1220,Public Welfare,1776,6162572,5,14092,881,1781,1781,6176664
0400000US35,35,New Mexico,,2014,1240,Health,2266,9183496,61,197193,10357,2325,2327,9380689
0400000US35,35,New Mexico,,2014,1260,Hospitals,6977,30016879,763,1758803,67784,7360,7740,31775682
0400000US35,35,New Mexico,,2014,1280,Social Insurance Administration,333,1026906,1,2179,113,334,334,1029085
0400000US35,35,New Mexico,,2014,1300,Solid Waste Management,0,0,0,0,0,0,0,0
0400000US35,35,New Mexico,,2014,1320,Sewerage,0,0,0,0,0,0,0,0
0400000US35,35,New Mexico,,2014,1340,Parks and Recreation,729,2292373,20,30274,2267,742,749,2322647
0400000US35,35,New Mexico,,2014,1360,Housing and Community Development,0,0,0,0,0,0,0,0
0400000US35,35,New Mexico,,2014,1380,Natural Resources,1027,4397894,70,82664,3740,1049,1097,4480558
0400000US35,35,New Mexico,,2014,1400,Water Supply,0,0,0,0,0,0,0,0
0400000US35,35,New Mexico,,2014,1420,Electric Power,0,0,0,0,0,0,0,0
0400000US35,35,New Mexico,,2014,1440,Gas Supply,0,0,0,0,0,0,0,0
0400000US35,35,New Mexico,,2014,1460,Transit,0,0,0,0,0,0,0,0
0400000US35,35,New Mexico,,2014,1480,Education Total ,15161,78292974,12664,15120442,761767,19468,27825,93413416
0400000US35,35,New Mexico,,2014,1481,Education - Elementary and Secondary Total ,0,0,0,0,0,0,0,0
0400000US35,35,New Mexico,,2014,14811,Education - Elementary and Secondary Instructional             ,0,0,0,0,0,0,0,0
0400000US35,35,New Mexico,,2014,14812,Education - Elementary and Secondary Other ,0,0,0,0,0,0,0,0
0400000US35,35,New Mexico,,2014,1482,Education - Higher Education Total ,14299,74686541,12601,15060734,757500,18580,26900,89747275
0400000US35,35,New Mexico,,2014,14821,Education - Higher Education Instructional,4038,34653798,4017,7268165,213146,5243,8055,41921963
0400000US35,35,New Mexico,,2014,14822,Education - Higher Education Other ,10261,40032743,8584,7792569,544354,13337,18845,47825312
0400000US35,35,New Mexico,,2014,1483,Education - Other,862,3606433,63,59708,4267,888,925,3666141
0400000US35,35,New Mexico,,2014,1500,Libraries                          ,0,0,0,0,0,0,0,0
0400000US35,35,New Mexico,,2014,1560,State liquor stores,0,0,0,0,0,0,0,0
0400000US35,35,New Mexico,,2014,1580,All other and unallocable,2067,8223440,9,17040,724,2072,2076,8240480
0400000US36,36,New York,,2014,1000,Total - All Government Employment Functions,222381,1337421790,46108,77277893,2922356,239928,268489,1414699683
0400000US36,36,New York,,2014,1020,Financial Administration,16191,90880983,171,445290,15053,16277,16362,91326273
0400000US36,36,New York,,2014,1040,Other Government Administration,4489,17916661,32,74867,3539,4510,4521,17991528
0400000US36,36,New York,,2014,1060,Judicial and Legal,18093,133038357,500,1895308,61543,18442,18593,134933665
0400000US36,36,New York,,2014,1100,Police Protection Total,5695,50011167,113,159504,15896,5785,5808,50170671
0400000US36,36,New York,,2014,1101,Police Protection - Persons with Power of Arrest       ,4574,45029779,0,0,0,4574,4574,45029779
0400000US36,36,New York,,2014,1102,Police Protection - Other ,1121,4981388,113,159504,15896,1211,1234,5140892
0400000US36,36,New York,,2014,1120,Fire Protection Total ,0,0,0,0,0,0,0,0
0400000US36,36,New York,,2014,1121,Fire Protection - Firefighters,0,0,0,0,0,0,0,0
0400000US36,36,New York,,2014,1122,Fire Protection - Other ,0,0,0,0,0,0,0,0
0400000US36,36,New York,,2014,1140,Corrections,28918,176372387,277,954946,30090,29089,29195,177327333
0400000US36,36,New York,,2014,1160,Highways,10119,58293755,1112,1531904,92152,10641,11231,59825659
0400000US36,36,New York,,2014,1180,Air Transportation,192,878744,2,4703,193,193,194,883447
0400000US36,36,New York,,2014,1200,Water Transport and Terminals       ,533,3241130,11,21448,941,538,544,3262578
0400000US36,36,New York,,2014,1220,Public Welfare,4053,21105845,403,1113226,53409,4354,4456,22219071
0400000US36,36,New York,,2014,1240,Health,7772,46422488,269,1031653,29850,7942,8041,47454141
0400000US36,36,New York,,2014,1260,Hospitals,38722,216651481,4469,13723878,469510,41396,43191,230375359
0400000US36,36,New York,,2014,1280,Social Insurance Administration,7839,41064671,47,160873,6546,7876,7886,41225544
0400000US36,36,New York,,2014,1300,Solid Waste Management,0,0,0,0,0,0,0,0
0400000US36,36,New York,,2014,1320,Sewerage,0,0,0,0,0,0,0,0
0400000US36,36,New York,,2014,1340,Parks and Recreation,2650,10313022,7,22276,1196,2657,2657,10335298
0400000US36,36,New York,,2014,1360,Housing and Community Development,0,0,0,0,0,0,0,0
0400000US36,36,New York,,2014,1380,Natural Resources,2923,16231950,57,74965,2653,2938,2980,16306915
0400000US36,36,New York,,2014,1400,Water Supply,0,0,0,0,0,0,0,0
0400000US36,36,New York,,2014,1420,Electric Power,1611,12897647,30,102612,2624,1626,1641,13000259
0400000US36,36,New York,,2014,1440,Gas Supply,0,0,0,0,0,0,0,0
0400000US36,36,New York,,2014,1460,Transit,14961,111088996,115,201792,11479,15026,15076,111290788
0400000US36,36,New York,,2014,1480,Education Total ,48123,276790423,38100,54633946,2094847,60959,86223,331424369
0400000US36,36,New York,,2014,1481,Education - Elementary and Secondary Total ,0,0,0,0,0,0,0,0
0400000US36,36,New York,,2014,14811,Education - Elementary and Secondary Instructional             ,0,0,0,0,0,0,0,0
0400000US36,36,New York,,2014,14812,Education - Elementary and Secondary Other ,0,0,0,0,0,0,0,0
0400000US36,36,New York,,2014,1482,Education - Higher Education Total ,44266,255656349,37987,54368653,2084247,57042,82253,310025002
0400000US36,36,New York,,2014,14821,Education - Higher Education Instructional,14981,113843555,17512,31622329,873751,20316,32493,145465884
0400000US36,36,New York,,2014,14822,Education - Higher Education Other ,29285,141812794,20475,22746324,1210496,36726,49760,164559118
0400000US36,36,New York,,2014,1483,Education - Other,3857,21134074,113,265293,10600,3917,3970,21399367
0400000US36,36,New York,,2014,1500,Libraries                          ,0,0,0,0,0,0,0,0
0400000US36,36,New York,,2014,1560,State liquor stores,0,0,0,0,0,0,0,0
0400000US36,36,New York,,2014,1580,All other and unallocable,9497,54222083,393,1124702,30835,9679,9890,55346785
0400000US37,37,North Carolina,,2014,1000,Total - All Government Employment Functions,127043,589400501,44338,61446982,3265572,145495,171381,650847483
0400000US37,37,North Carolina,,2014,1020,Financial Administration,3561,16667467,25,17612,437,3564,3586,16685079
0400000US37,37,North Carolina,,2014,1040,Other Government Administration,767,3772251,435,933401,52683,1065,1202,4705652
0400000US37,37,North Carolina,,2014,1060,Judicial and Legal,6272,29744043,467,337765,3824,6293,6739,30081808
0400000US37,37,North Carolina,,2014,1100,Police Protection Total,2869,17050387,0,0,0,2869,2869,17050387
0400000US37,37,North Carolina,,2014,1101,Police Protection - Persons with Power of Arrest       ,2270,13998087,0,0,0,2270,2270,13998087
0400000US37,37,North Carolina,,2014,1102,Police Protection - Other ,599,3052300,0,0,0,599,599,3052300
0400000US37,37,North Carolina,,2014,1120,Fire Protection Total ,0,0,0,0,0,0,0,0
0400000US37,37,North Carolina,,2014,1121,Fire Protection - Firefighters,0,0,0,0,0,0,0,0
0400000US37,37,North Carolina,,2014,1122,Fire Protection - Other ,0,0,0,0,0,0,0,0
0400000US37,37,North Carolina,,2014,1140,Corrections,19830,74459033,0,0,0,19830,19830,74459033
0400000US37,37,North Carolina,,2014,1160,Highways,10802,41574474,29,42789,4631,10828,10831,41617263
0400000US37,37,North Carolina,,2014,1180,Air Transportation,0,0,0,0,0,0,0,0
0400000US37,37,North Carolina,,2014,1200,Water Transport and Terminals       ,222,983442,1,1705,131,223,223,985147
0400000US37,37,North Carolina,,2014,1220,Public Welfare,1111,4076980,34,46656,1631,1120,1145,4123636
0400000US37,37,North Carolina,,2014,1240,Health,2617,10713868,158,304224,14070,2697,2775,11018092
0400000US37,37,North Carolina,,2014,1260,Hospitals,18036,73286226,1722,4296770,83158,18505,19758,77582996
0400000US37,37,North Carolina,,2014,1280,Social Insurance Administration,1542,6738570,78,114438,1468,1550,1620,6853008
0400000US37,37,North Carolina,,2014,1300,Solid Waste Management,281,1441026,0,0,0,281,281,1441026
0400000US37,37,North Carolina,,2014,1320,Sewerage,0,0,0,0,0,0,0,0
0400000US37,37,North Carolina,,2014,1340,Parks and Recreation,1386,4654215,43,55397,4408,1411,1429,4709612
0400000US37,37,North Carolina,,2014,1360,Housing and Community Development,0,0,0,0,0,0,0,0
0400000US37,37,North Carolina,,2014,1380,Natural Resources,3967,14975182,210,246774,11114,4031,4177,15221956
0400000US37,37,North Carolina,,2014,1400,Water Supply,0,0,0,0,0,0,0,0
0400000US37,37,North Carolina,,2014,1420,Electric Power,0,0,0,0,0,0,0,0
0400000US37,37,North Carolina,,2014,1440,Gas Supply,0,0,0,0,0,0,0,0
0400000US37,37,North Carolina,,2014,1460,Transit,0,0,0,0,0,0,0,0
0400000US37,37,North Carolina,,2014,1480,Education Total ,48991,267229657,40635,54097491,3028495,66102,89626,321327148
0400000US37,37,North Carolina,,2014,1481,Education - Elementary and Secondary Total ,0,0,0,0,0,0,0,0
0400000US37,37,North Carolina,,2014,14811,Education - Elementary and Secondary Instructional             ,0,0,0,0,0,0,0,0
0400000US37,37,North Carolina,,2014,14812,Education - Elementary and Secondary Other ,0,0,0,0,0,0,0,0
0400000US37,37,North Carolina,,2014,1482,Education - Higher Education Total ,45157,249199093,40379,53946283,3026915,62259,85536,303145376
0400000US37,37,North Carolina,,2014,14821,Education - Higher Education Instructional,15501,118912458,13953,31245186,1246993,22548,29454,150157644
0400000US37,37,North Carolina,,2014,14822,Education - Higher Education Other ,29656,130286635,26426,22701097,1779922,39711,56082,152987732
0400000US37,37,North Carolina,,2014,1483,Education - Other,3834,18030564,256,151208,1580,3843,4090,18181772
0400000US37,37,North Carolina,,2014,1500,Libraries                          ,0,0,0,0,0,0,0,0
0400000US37,37,North Carolina,,2014,1560,State liquor stores,0,0,0,0,0,0,0,0
0400000US37,37,North Carolina,,2014,1580,All other and unallocable,4789,22033680,501,951960,59522,5126,5290,22985640
0400000US38,38,North Dakota,,2014,1000,Total - All Government Employment Functions,15747,72319005,9760,10287457,531993,18752,25507,82606462
0400000US38,38,North Dakota,,2014,1020,Financial Administration,669,2925766,46,86175,3518,688,715,3011941
0400000US38,38,North Dakota,,2014,1040,Other Government Administration,205,942728,152,108288,4295,230,357,1051016
0400000US38,38,North Dakota,,2014,1060,Judicial and Legal,591,3206223,45,41318,1896,602,636,3247541
0400000US38,38,North Dakota,,2014,1100,Police Protection Total,205,1096743,7,7025,357,207,212,1103768
0400000US38,38,North Dakota,,2014,1101,Police Protection - Persons with Power of Arrest       ,160,928281,0,0,0,160,160,928281
0400000US38,38,North Dakota,,2014,1102,Police Protection - Other ,45,168462,7,7025,357,47,52,175487
0400000US38,38,North Dakota,,2014,1120,Fire Protection Total ,0,0,0,0,0,0,0,0
0400000US38,38,North Dakota,,2014,1121,Fire Protection - Firefighters,0,0,0,0,0,0,0,0
0400000US38,38,North Dakota,,2014,1122,Fire Protection - Other ,0,0,0,0,0,0,0,0
0400000US38,38,North Dakota,,2014,1140,Corrections,835,3255585,98,220967,7083,875,933,3476552
0400000US38,38,North Dakota,,2014,1160,Highways,1021,5487643,6,12163,543,1024,1027,5499806
0400000US38,38,North Dakota,,2014,1180,Air Transportation,0,0,0,0,0,0,0,0
0400000US38,38,North Dakota,,2014,1200,Water Transport and Terminals       ,0,0,0,0,0,0,0,0
0400000US38,38,North Dakota,,2014,1220,Public Welfare,462,1562455,128,241616,14315,543,590,1804071
0400000US38,38,North Dakota,,2014,1240,Health,1553,5999344,361,365937,25982,1700,1914,6365281
0400000US38,38,North Dakota,,2014,1260,Hospitals,877,2554582,146,205315,7751,921,1023,2759897
0400000US38,38,North Dakota,,2014,1280,Social Insurance Administration,315,1294659,68,88547,4832,342,383,1383206
0400000US38,38,North Dakota,,2014,1300,Solid Waste Management,0,0,0,0,0,0,0,0
0400000US38,38,North Dakota,,2014,1320,Sewerage,0,0,0,0,0,0,0,0
0400000US38,38,North Dakota,,2014,1340,Parks and Recreation,172,593260,11,20175,1004,178,183,613435
0400000US38,38,North Dakota,,2014,1360,Housing and Community Development,0,0,0,0,0,0,0,0
0400000US38,38,North Dakota,,2014,1380,Natural Resources,917,3959042,492,571865,30272,1086,1409,4530907
0400000US38,38,North Dakota,,2014,1400,Water Supply,0,0,0,0,0,0,0,0
0400000US38,38,North Dakota,,2014,1420,Electric Power,0,0,0,0,0,0,0,0
0400000US38,38,North Dakota,,2014,1440,Gas Supply,0,0,0,0,0,0,0,0
0400000US38,38,North Dakota,,2014,1460,Transit,0,0,0,0,0,0,0,0
0400000US38,38,North Dakota,,2014,1480,Education Total ,6424,32243480,8075,8161014,423019,8816,14499,40404494
0400000US38,38,North Dakota,,2014,1481,Education - Elementary and Secondary Total ,0,0,0,0,0,0,0,0
0400000US38,38,North Dakota,,2014,14811,Education - Elementary and Secondary Instructional             ,0,0,0,0,0,0,0,0
0400000US38,38,North Dakota,,2014,14812,Education - Elementary and Secondary Other ,0,0,0,0,0,0,0,0
0400000US38,38,North Dakota,,2014,1482,Education - Higher Education Total ,6114,30999872,8030,8076933,419480,8486,14144,39076805
0400000US38,38,North Dakota,,2014,14821,Education - Higher Education Instructional,2053,14558155,2944,5223879,187341,3112,4997,19782034
0400000US38,38,North Dakota,,2014,14822,Education - Higher Education Other ,4061,16441717,5086,2853054,232139,5374,9147,19294771
0400000US38,38,North Dakota,,2014,1483,Education - Other,310,1243608,45,84081,3539,330,355,1327689
0400000US38,38,North Dakota,,2014,1500,Libraries                          ,0,0,0,0,0,0,0,0
0400000US38,38,North Dakota,,2014,1560,State liquor stores,0,0,0,0,0,0,0,0
0400000US38,38,North Dakota,,2014,1580,All other and unallocable,1501,7197495,125,157052,7126,1540,1626,7354547
0400000US39,39,Ohio,,2014,1000,Total - All Government Employment Functions,108636,567073786,79910,88641017,4898931,136355,188546,655714803
0400000US39,39,Ohio,,2014,1020,Financial Administration,6404,35089506,261,547806,28642,6565,6665,35637312
0400000US39,39,Ohio,,2014,1040,Other Government Administration,699,3150733,159,107763,9441,752,858,3258496
0400000US39,39,Ohio,,2014,1060,Judicial and Legal,2816,16592595,533,1337035,40255,3043,3349,17929630
0400000US39,39,Ohio,,2014,1100,Police Protection Total,2599,13368062,9,26297,1499,2607,2608,13394359
0400000US39,39,Ohio,,2014,1101,Police Protection - Persons with Power of Arrest       ,1429,8421881,0,0,0,1429,1429,8421881
0400000US39,39,Ohio,,2014,1102,Police Protection - Other ,1170,4946181,9,26297,1499,1178,1179,4972478
0400000US39,39,Ohio,,2014,1120,Fire Protection Total ,0,0,0,0,0,0,0,0
0400000US39,39,Ohio,,2014,1121,Fire Protection - Firefighters,0,0,0,0,0,0,0,0
0400000US39,39,Ohio,,2014,1122,Fire Protection - Other ,0,0,0,0,0,0,0,0
0400000US39,39,Ohio,,2014,1140,Corrections,13096,58064324,21,58048,3093,13113,13117,58122372
0400000US39,39,Ohio,,2014,1160,Highways,5684,27295621,730,1568449,96401,6228,6414,28864070
0400000US39,39,Ohio,,2014,1180,Air Transportation,0,0,0,0,0,0,0,0
0400000US39,39,Ohio,,2014,1200,Water Transport and Terminals       ,0,0,0,0,0,0,0,0
0400000US39,39,Ohio,,2014,1220,Public Welfare,2646,14976114,340,787894,46702,2920,2986,15764008
0400000US39,39,Ohio,,2014,1240,Health,3028,17055344,196,470143,25830,3174,3224,17525487
0400000US39,39,Ohio,,2014,1260,Hospitals,12508,61647675,5914,13516635,561677,15681,18422,75164310
0400000US39,39,Ohio,,2014,1280,Social Insurance Administration,1814,8073953,133,198998,11696,1889,1947,8272951
0400000US39,39,Ohio,,2014,1300,Solid Waste Management,0,0,0,0,0,0,0,0
0400000US39,39,Ohio,,2014,1320,Sewerage,0,0,0,0,0,0,0,0
0400000US39,39,Ohio,,2014,1340,Parks and Recreation,391,1681252,248,336441,22083,516,639,2017693
0400000US39,39,Ohio,,2014,1360,Housing and Community Development,0,0,0,0,0,0,0,0
0400000US39,39,Ohio,,2014,1380,Natural Resources,2234,9978624,375,705110,42958,2476,2609,10683734
0400000US39,39,Ohio,,2014,1400,Water Supply,0,0,0,0,0,0,0,0
0400000US39,39,Ohio,,2014,1420,Electric Power,0,0,0,0,0,0,0,0
0400000US39,39,Ohio,,2014,1440,Gas Supply,0,0,0,0,0,0,0,0
0400000US39,39,Ohio,,2014,1460,Transit,0,0,0,0,0,0,0,0
0400000US39,39,Ohio,,2014,1480,Education Total ,50316,276672169,70689,68506644,3985510,72859,121005,345178813
0400000US39,39,Ohio,,2014,1481,Education - Elementary and Secondary Total ,0,0,0,0,0,0,0,0
0400000US39,39,Ohio,,2014,14811,Education - Elementary and Secondary Instructional             ,0,0,0,0,0,0,0,0
0400000US39,39,Ohio,,2014,14812,Education - Elementary and Secondary Other ,0,0,0,0,0,0,0,0
0400000US39,39,Ohio,,2014,1482,Education - Higher Education Total ,48396,266619719,70520,68239175,3972693,70866,118916,334858894
0400000US39,39,Ohio,,2014,14821,Education - Higher Education Instructional,16438,121465425,21009,31920345,1171052,23067,37447,153385770
0400000US39,39,Ohio,,2014,14822,Education - Higher Education Other ,31958,145154294,49511,36318830,2801641,47799,81469,181473124
0400000US39,39,Ohio,,2014,1483,Education - Other,1920,10052450,169,267469,12817,1993,2089,10319919
0400000US39,39,Ohio,,2014,1500,Libraries                          ,0,0,0,0,0,0,0,0
0400000US39,39,Ohio,,2014,1560,State liquor stores,0,0,0,0,0,0,0,0
0400000US39,39,Ohio,,2014,1580,All other and unallocable,4401,23427814,302,473754,23144,4532,4703,23901568
0400000US40,40,Oklahoma,,2014,1000,Total - All Government Employment Functions,60113,241787017,24752,23117941,1345403,67729,84865,264904958
0400000US40,40,Oklahoma,,2014,1020,Financial Administration,2861,11575230,80,93229,5412,2891,2941,11668459
0400000US40,40,Oklahoma,,2014,1040,Other Government Administration,451,1767056,92,168339,10837,512,543,1935395
0400000US40,40,Oklahoma,,2014,1060,Judicial and Legal,2806,12448723,121,172137,8662,2856,2927,12620860
0400000US40,40,Oklahoma,,2014,1100,Police Protection Total,1866,8623296,50,58865,3593,1886,1916,8682161
0400000US40,40,Oklahoma,,2014,1101,Police Protection - Persons with Power of Arrest       ,941,5008861,3,5086,174,942,944,5013947
0400000US40,40,Oklahoma,,2014,1102,Police Protection - Other ,925,3614435,47,53779,3419,944,972,3668214
0400000US40,40,Oklahoma,,2014,1120,Fire Protection Total ,0,0,0,0,0,0,0,0
0400000US40,40,Oklahoma,,2014,1121,Fire Protection - Firefighters,0,0,0,0,0,0,0,0
0400000US40,40,Oklahoma,,2014,1122,Fire Protection - Other ,0,0,0,0,0,0,0,0
0400000US40,40,Oklahoma,,2014,1140,Corrections,4605,14303030,64,117590,4165,4628,4669,14420620
0400000US40,40,Oklahoma,,2014,1160,Highways,2875,10731962,0,0,0,2875,2875,10731962
0400000US40,40,Oklahoma,,2014,1180,Air Transportation,10,51200,1,990,99,11,11,52190
0400000US40,40,Oklahoma,,2014,1200,Water Transport and Terminals       ,0,0,0,0,0,0,0,0
0400000US40,40,Oklahoma,,2014,1220,Public Welfare,8162,21610281,8,14891,822,8168,8170,21625172
0400000US40,40,Oklahoma,,2014,1240,Health,5206,20222677,319,731673,29192,5370,5525,20954350
0400000US40,40,Oklahoma,,2014,1260,Hospitals,1588,5830422,50,83270,4351,1613,1638,5913692
0400000US40,40,Oklahoma,,2014,1280,Social Insurance Administration,850,3169915,60,259854,6848,888,910,3429769
0400000US40,40,Oklahoma,,2014,1300,Solid Waste Management,76,375107,9,6700,609,79,85,381807
0400000US40,40,Oklahoma,,2014,1320,Sewerage,0,0,0,0,0,0,0,0
0400000US40,40,Oklahoma,,2014,1340,Parks and Recreation,558,1577087,287,291388,28052,716,845,1868475
0400000US40,40,Oklahoma,,2014,1360,Housing and Community Development,0,0,0,0,0,0,0,0
0400000US40,40,Oklahoma,,2014,1380,Natural Resources,1550,5597700,828,792234,46376,1811,2378,6389934
0400000US40,40,Oklahoma,,2014,1400,Water Supply,0,0,0,0,0,0,0,0
0400000US40,40,Oklahoma,,2014,1420,Electric Power,590,3397852,16,24523,1144,596,606,3422375
0400000US40,40,Oklahoma,,2014,1440,Gas Supply,0,0,0,0,0,0,0,0
0400000US40,40,Oklahoma,,2014,1460,Transit,0,0,0,0,0,0,0,0
0400000US40,40,Oklahoma,,2014,1480,Education Total ,23767,111205342,22648,20109421,1185254,30485,46415,131314763
0400000US40,40,Oklahoma,,2014,1481,Education - Elementary and Secondary Total ,0,0,0,0,0,0,0,0
0400000US40,40,Oklahoma,,2014,14811,Education - Elementary and Secondary Instructional             ,0,0,0,0,0,0,0,0
0400000US40,40,Oklahoma,,2014,14812,Education - Elementary and Secondary Other ,0,0,0,0,0,0,0,0
0400000US40,40,Oklahoma,,2014,1482,Education - Higher Education Total ,22096,104635826,22597,20051349,1181581,28793,44693,124687175
0400000US40,40,Oklahoma,,2014,14821,Education - Higher Education Instructional,6373,43614990,6586,8938189,311248,8136,12959,52553179
0400000US40,40,Oklahoma,,2014,14822,Education - Higher Education Other ,15723,61020836,16011,11113160,870333,20657,31734,72133996
0400000US40,40,Oklahoma,,2014,1483,Education - Other,1671,6569516,51,58072,3673,1692,1722,6627588
0400000US40,40,Oklahoma,,2014,1500,Libraries                          ,0,0,0,0,0,0,0,0
0400000US40,40,Oklahoma,,2014,1560,State liquor stores,0,0,0,0,0,0,0,0
0400000US40,40,Oklahoma,,2014,1580,All other and unallocable,2292,9300137,119,192837,9987,2344,2411,9492974
0400000US41,41,Oregon,,2014,1000,Total - All Government Employment Functions,57826,286562941,24455,40007649,1617336,66966,82281,326570590
0400000US41,41,Oregon,,2014,1020,Financial Administration,3863,17796521,165,260039,13968,3943,4028,18056560
0400000US41,41,Oregon,,2014,1040,Other Government Administration,894,4533673,176,382765,17181,992,1070,4916438
0400000US41,41,Oregon,,2014,1060,Judicial and Legal,2920,14722695,174,534345,17763,3020,3094,15257040
0400000US41,41,Oregon,,2014,1100,Police Protection Total,1331,7188710,137,114331,5103,1360,1468,7303041
0400000US41,41,Oregon,,2014,1101,Police Protection - Persons with Power of Arrest       ,673,4197306,0,0,0,673,673,4197306
0400000US41,41,Oregon,,2014,1102,Police Protection - Other ,658,2991404,137,114331,5103,687,795,3105735
0400000US41,41,Oregon,,2014,1120,Fire Protection Total ,0,0,0,0,0,0,0,0
0400000US41,41,Oregon,,2014,1121,Fire Protection - Firefighters,0,0,0,0,0,0,0,0
0400000US41,41,Oregon,,2014,1122,Fire Protection - Other ,0,0,0,0,0,0,0,0
0400000US41,41,Oregon,,2014,1140,Corrections,5012,24448927,133,280353,9886,5068,5145,24729280
0400000US41,41,Oregon,,2014,1160,Highways,3528,18114958,231,607514,26563,3678,3759,18722472
0400000US41,41,Oregon,,2014,1180,Air Transportation,11,52696,1,2526,120,12,12,55222
0400000US41,41,Oregon,,2014,1200,Water Transport and Terminals       ,0,0,0,0,0,0,0,0
0400000US41,41,Oregon,,2014,1220,Public Welfare,7353,27846327,379,714144,30637,7527,7732,28560471
0400000US41,41,Oregon,,2014,1240,Health,2096,9379481,153,406279,14211,2177,2249,9785760
0400000US41,41,Oregon,,2014,1260,Hospitals,5473,25578270,3295,15779221,443943,7982,8768,41357491
0400000US41,41,Oregon,,2014,1280,Social Insurance Administration,1998,12398311,77,255033,8110,2044,2075,12653344
0400000US41,41,Oregon,,2014,1300,Solid Waste Management,0,0,0,0,0,0,0,0
0400000US41,41,Oregon,,2014,1320,Sewerage,0,0,0,0,0,0,0,0
0400000US41,41,Oregon,,2014,1340,Parks and Recreation,431,1862860,13,24915,1320,438,444,1887775
0400000US41,41,Oregon,,2014,1360,Housing and Community Development,0,0,0,0,0,0,0,0
0400000US41,41,Oregon,,2014,1380,Natural Resources,2400,10817487,251,398250,21457,2520,2651,11215737
0400000US41,41,Oregon,,2014,1400,Water Supply,0,0,0,0,0,0,0,0
0400000US41,41,Oregon,,2014,1420,Electric Power,0,0,0,0,0,0,0,0
0400000US41,41,Oregon,,2014,1440,Gas Supply,0,0,0,0,0,0,0,0
0400000US41,41,Oregon,,2014,1460,Transit,0,0,0,0,0,0,0,0
0400000US41,41,Oregon,,2014,1480,Education Total ,18944,104122038,19174,20122789,1002086,24606,38118,124244827
0400000US41,41,Oregon,,2014,1481,Education - Elementary and Secondary Total ,0,0,0,0,0,0,0,0
0400000US41,41,Oregon,,2014,14811,Education - Elementary and Secondary Instructional             ,0,0,0,0,0,0,0,0
0400000US41,41,Oregon,,2014,14812,Education - Elementary and Secondary Other ,0,0,0,0,0,0,0,0
0400000US41,41,Oregon,,2014,1482,Education - Higher Education Total ,18167,100287867,19107,20030640,997499,23803,37274,120318507
0400000US41,41,Oregon,,2014,14821,Education - Higher Education Instructional,10181,70206864,3258,7509946,204836,11338,13439,77716810
0400000US41,41,Oregon,,2014,14822,Education - Higher Education Other ,7986,30081003,15849,12520694,792663,12465,23835,42601697
0400000US41,41,Oregon,,2014,1483,Education - Other,777,3834171,67,92149,4587,803,844,3926320
0400000US41,41,Oregon,,2014,1500,Libraries                          ,0,0,0,0,0,0,0,0
0400000US41,41,Oregon,,2014,1560,State liquor stores,206,906619,8,11254,671,210,214,917873
0400000US41,41,Oregon,,2014,1580,All other and unallocable,1366,6793368,88,113891,4317,1389,1454,6907259
0400000US42,42,Pennsylvania,,2014,1000,Total - All Government Employment Functions,140760,689205344,64995,108618120,3655546,162248,205755,797823464
0400000US42,42,Pennsylvania,,2014,1020,Financial Administration,6343,28062555,1039,2282403,107273,6990,7382,30344958
0400000US42,42,Pennsylvania,,2014,1040,Other Government Administration,2742,12082433,486,2211938,54177,3068,3228,14294371
0400000US42,42,Pennsylvania,,2014,1060,Judicial and Legal,3050,26410822,0,0,0,3050,3050,26410822
0400000US42,42,Pennsylvania,,2014,1100,Police Protection Total,6566,40307281,332,952269,17342,6671,6898,41259550
0400000US42,42,Pennsylvania,,2014,1101,Police Protection - Persons with Power of Arrest       ,5195,31879630,8,14377,748,5200,5203,31894007
0400000US42,42,Pennsylvania,,2014,1102,Police Protection - Other ,1371,8427651,324,937892,16594,1471,1695,9365543
0400000US42,42,Pennsylvania,,2014,1120,Fire Protection Total ,0,0,0,0,0,0,0,0
0400000US42,42,Pennsylvania,,2014,1121,Fire Protection - Firefighters,0,0,0,0,0,0,0,0
0400000US42,42,Pennsylvania,,2014,1122,Fire Protection - Other ,0,0,0,0,0,0,0,0
0400000US42,42,Pennsylvania,,2014,1140,Corrections,18033,82121958,721,2416485,57782,18381,18754,84538443
0400000US42,42,Pennsylvania,,2014,1160,Highways,12471,49395513,2838,6628037,185225,13581,15309,56023550
0400000US42,42,Pennsylvania,,2014,1180,Air Transportation,119,446931,31,70368,2163,132,150,517299
0400000US42,42,Pennsylvania,,2014,1200,Water Transport and Terminals       ,186,801403,54,153598,4710,214,240,955001
0400000US42,42,Pennsylvania,,2014,1220,Public Welfare,10421,40239280,1648,3373751,107190,11066,12069,43613031
0400000US42,42,Pennsylvania,,2014,1240,Health,1643,8094925,367,1014381,10576,1706,2010,9109306
0400000US42,42,Pennsylvania,,2014,1260,Hospitals,10489,36361799,1658,2818808,87496,11005,12147,39180607
0400000US42,42,Pennsylvania,,2014,1280,Social Insurance Administration,3949,15959066,635,1943893,47105,4233,4584,17902959
0400000US42,42,Pennsylvania,,2014,1300,Solid Waste Management,0,0,0,0,0,0,0,0
0400000US42,42,Pennsylvania,,2014,1320,Sewerage,0,0,0,0,0,0,0,0
0400000US42,42,Pennsylvania,,2014,1340,Parks and Recreation,1610,6800704,1375,3526629,173713,2657,2985,10327333
0400000US42,42,Pennsylvania,,2014,1360,Housing and Community Development,0,0,0,0,0,0,0,0
0400000US42,42,Pennsylvania,,2014,1380,Natural Resources,5029,23878275,2640,5389651,119166,5726,7669,29267926
0400000US42,42,Pennsylvania,,2014,1400,Water Supply,0,0,0,0,0,0,0,0
0400000US42,42,Pennsylvania,,2014,1420,Electric Power,0,0,0,0,0,0,0,0
0400000US42,42,Pennsylvania,,2014,1440,Gas Supply,0,0,0,0,0,0,0,0
0400000US42,42,Pennsylvania,,2014,1460,Transit,0,0,0,0,0,0,0,0
0400000US42,42,Pennsylvania,,2014,1480,Education Total ,49461,281217032,47736,69516230,2405584,63457,97197,350733262
0400000US42,42,Pennsylvania,,2014,1481,Education - Elementary and Secondary Total ,0,0,0,0,0,0,0,0
0400000US42,42,Pennsylvania,,2014,14811,Education - Elementary and Secondary Instructional             ,0,0,0,0,0,0,0,0
0400000US42,42,Pennsylvania,,2014,14812,Education - Elementary and Secondary Other ,0,0,0,0,0,0,0,0
0400000US42,42,Pennsylvania,,2014,1482,Education - Higher Education Total ,44688,261762974,47430,68602296,2385904,58567,92118,330365270
0400000US42,42,Pennsylvania,,2014,14821,Education - Higher Education Instructional,15257,129622895,12927,39039007,802519,19853,28184,168661902
0400000US42,42,Pennsylvania,,2014,14822,Education - Higher Education Other ,29431,132140079,34503,29563289,1583385,38714,63934,161703368
0400000US42,42,Pennsylvania,,2014,1483,Education - Other,4773,19454058,306,913934,19680,4890,5079,20367992
0400000US42,42,Pennsylvania,,2014,1500,Libraries                          ,0,0,0,0,0,0,0,0
0400000US42,42,Pennsylvania,,2014,1560,State liquor stores,3108,10893810,2596,5134842,230658,4498,5704,16028652
0400000US42,42,Pennsylvania,,2014,1580,All other and unallocable,5540,26131557,839,1184837,45386,5813,6379,27316394
0400000US44,44,Rhode Island,,2014,1000,Total - All Government Employment Functions,17041,95347209,7053,6850227,259260,18659,24094,102197436
0400000US44,44,Rhode Island,,2014,1020,Financial Administration,881,4861182,5,22291,527,884,886,4883473
0400000US44,44,Rhode Island,,2014,1040,Other Government Administration,732,3871415,337,351098,8122,785,1069,4222513
0400000US44,44,Rhode Island,,2014,1060,Judicial and Legal,1169,6947930,18,43048,1566,1180,1187,6990978
0400000US44,44,Rhode Island,,2014,1100,Police Protection Total,345,2506422,0,0,0,345,345,2506422
0400000US44,44,Rhode Island,,2014,1101,Police Protection - Persons with Power of Arrest       ,262,1966142,0,0,0,262,262,1966142
0400000US44,44,Rhode Island,,2014,1102,Police Protection - Other ,83,540280,0,0,0,83,83,540280
0400000US44,44,Rhode Island,,2014,1120,Fire Protection Total ,0,0,0,0,0,0,0,0
0400000US44,44,Rhode Island,,2014,1121,Fire Protection - Firefighters,0,0,0,0,0,0,0,0
0400000US44,44,Rhode Island,,2014,1122,Fire Protection - Other ,0,0,0,0,0,0,0,0
0400000US44,44,Rhode Island,,2014,1140,Corrections,1520,9758751,6,12734,202,1521,1526,9771485
0400000US44,44,Rhode Island,,2014,1160,Highways,713,3723080,71,82719,5551,746,784,3805799
0400000US44,44,Rhode Island,,2014,1180,Air Transportation,145,991258,2,6169,102,146,147,997427
0400000US44,44,Rhode Island,,2014,1200,Water Transport and Terminals       ,0,0,0,0,0,0,0,0
0400000US44,44,Rhode Island,,2014,1220,Public Welfare,1309,7628739,15,37375,1720,1320,1324,7666114
0400000US44,44,Rhode Island,,2014,1240,Health,981,5167440,26,13919,1397,990,1007,5181359
0400000US44,44,Rhode Island,,2014,1260,Hospitals,852,4222776,2,11835,295,854,854,4234611
0400000US44,44,Rhode Island,,2014,1280,Social Insurance Administration,374,1969534,11,28591,1016,381,385,1998125
0400000US44,44,Rhode Island,,2014,1300,Solid Waste Management,97,598242,4,7356,257,98,101,605598
0400000US44,44,Rhode Island,,2014,1320,Sewerage,252,1269935,0,0,0,252,252,1269935
0400000US44,44,Rhode Island,,2014,1340,Parks and Recreation,49,187667,0,0,0,49,49,187667
0400000US44,44,Rhode Island,,2014,1360,Housing and Community Development,0,0,0,0,0,0,0,0
0400000US44,44,Rhode Island,,2014,1380,Natural Resources,376,2185236,0,0,0,376,376,2185236
0400000US44,44,Rhode Island,,2014,1400,Water Supply,0,0,0,0,0,0,0,0
0400000US44,44,Rhode Island,,2014,1420,Electric Power,0,0,0,0,0,0,0,0
0400000US44,44,Rhode Island,,2014,1440,Gas Supply,0,0,0,0,0,0,0,0
0400000US44,44,Rhode Island,,2014,1460,Transit,781,3841586,0,0,0,781,781,3841586
0400000US44,44,Rhode Island,,2014,1480,Education Total ,4841,25785862,6527,6183659,236353,6312,11368,31969521
0400000US44,44,Rhode Island,,2014,1481,Education - Elementary and Secondary Total ,361,1959204,74,66747,7048,414,435,2025951
0400000US44,44,Rhode Island,,2014,14811,Education - Elementary and Secondary Instructional             ,254,1617925,5,7535,166,255,259,1625460
0400000US44,44,Rhode Island,,2014,14812,Education - Elementary and Secondary Other ,107,341279,69,59212,6882,159,176,400491
0400000US44,44,Rhode Island,,2014,1482,Education - Higher Education Total ,3989,20847124,6441,6087267,228282,5401,10430,26934391
0400000US44,44,Rhode Island,,2014,14821,Education - Higher Education Instructional,1352,8791899,2267,3782479,78904,1838,3619,12574378
0400000US44,44,Rhode Island,,2014,14822,Education - Higher Education Other ,2637,12055225,4174,2304788,149378,3563,6811,14360013
0400000US44,44,Rhode Island,,2014,1483,Education - Other,491,2979534,12,29645,1023,497,503,3009179
0400000US44,44,Rhode Island,,2014,1500,Libraries                          ,0,0,0,0,0,0,0,0
0400000US44,44,Rhode Island,,2014,1560,State liquor stores,0,0,0,0,0,0,0,0
0400000US44,44,Rhode Island,,2014,1580,All other and unallocable,1624,9830154,29,49433,2152,1639,1653,9879587
0400000US45,45,South Carolina,,2014,1000,Total - All Government Employment Functions,70754,284051487,21553,23484053,1340437,78707,92307,307535540
0400000US45,45,South Carolina,,2014,1020,Financial Administration,3221,11561832,196,328112,21350,3351,3417,11889944
0400000US45,45,South Carolina,,2014,1040,Other Government Administration,544,2181092,522,358614,28131,712,1066,2539706
0400000US45,45,South Carolina,,2014,1060,Judicial and Legal,829,3994864,14,23126,1138,836,843,4017990
0400000US45,45,South Carolina,,2014,1100,Police Protection Total,2055,7568916,5,8832,556,2058,2060,7577748
0400000US45,45,South Carolina,,2014,1101,Police Protection - Persons with Power of Arrest       ,1379,5397972,0,0,0,1379,1379,5397972
0400000US45,45,South Carolina,,2014,1102,Police Protection - Other ,676,2170944,5,8832,556,679,681,2179776
0400000US45,45,South Carolina,,2014,1120,Fire Protection Total ,0,0,0,0,0,0,0,0
0400000US45,45,South Carolina,,2014,1121,Fire Protection - Firefighters,0,0,0,0,0,0,0,0
0400000US45,45,South Carolina,,2014,1122,Fire Protection - Other ,0,0,0,0,0,0,0,0
0400000US45,45,South Carolina,,2014,1140,Corrections,8183,23152230,85,175646,6808,8224,8268,23327876
0400000US45,45,South Carolina,,2014,1160,Highways,4276,14237116,5,10552,680,4280,4281,14247668
0400000US45,45,South Carolina,,2014,1180,Air Transportation,13,61462,1,660,22,13,14,62122
0400000US45,45,South Carolina,,2014,1200,Water Transport and Terminals       ,487,2510650,6,6734,228,488,493,2517384
0400000US45,45,South Carolina,,2014,1220,Public Welfare,4776,13672186,8,17082,908,4781,4784,13689268
0400000US45,45,South Carolina,,2014,1240,Health,5043,17550235,315,796334,33784,5245,5358,18346569
0400000US45,45,South Carolina,,2014,1260,Hospitals,6776,20468062,313,1286437,39324,7001,7089,21754499
0400000US45,45,South Carolina,,2014,1280,Social Insurance Administration,1103,3600482,50,71562,4452,1130,1153,3672044
0400000US45,45,South Carolina,,2014,1300,Solid Waste Management,0,0,0,0,0,0,0,0
0400000US45,45,South Carolina,,2014,1320,Sewerage,0,0,0,0,0,0,0,0
0400000US45,45,South Carolina,,2014,1340,Parks and Recreation,738,1679996,47,32946,3186,757,785,1712942
0400000US45,45,South Carolina,,2014,1360,Housing and Community Development,138,589582,1,316,10,138,139,589898
0400000US45,45,South Carolina,,2014,1380,Natural Resources,1988,6421816,264,220502,24784,2138,2252,6642318
0400000US45,45,South Carolina,,2014,1400,Water Supply,12,71440,0,0,0,12,12,71440
0400000US45,45,South Carolina,,2014,1420,Electric Power,1735,11368803,7,28688,943,1740,1742,11397491
0400000US45,45,South Carolina,,2014,1440,Gas Supply,0,0,0,0,0,0,0,0
0400000US45,45,South Carolina,,2014,1460,Transit,0,0,0,0,0,0,0,0
0400000US45,45,South Carolina,,2014,1480,Education Total ,27371,138027933,19648,20028892,1169363,34309,47019,158056825
0400000US45,45,South Carolina,,2014,1481,Education - Elementary and Secondary Total ,0,0,0,0,0,0,0,0
0400000US45,45,South Carolina,,2014,14811,Education - Elementary and Secondary Instructional             ,0,0,0,0,0,0,0,0
0400000US45,45,South Carolina,,2014,14812,Education - Elementary and Secondary Other ,0,0,0,0,0,0,0,0
0400000US45,45,South Carolina,,2014,1482,Education - Higher Education Total ,24499,127464539,19379,19639358,1149823,31320,43878,147103897
0400000US45,45,South Carolina,,2014,14821,Education - Higher Education Instructional,8812,59641346,7737,9562473,408432,11237,16549,69203819
0400000US45,45,South Carolina,,2014,14822,Education - Higher Education Other ,15687,67823193,11642,10076885,741391,20083,27329,77900078
0400000US45,45,South Carolina,,2014,1483,Education - Other,2872,10563394,269,389534,19540,2989,3141,10952928
0400000US45,45,South Carolina,,2014,1500,Libraries                          ,35,130096,0,0,0,35,35,130096
0400000US45,45,South Carolina,,2014,1560,State liquor stores,0,0,0,0,0,0,0,0
0400000US45,45,South Carolina,,2014,1580,All other and unallocable,1431,5202694,66,89018,4770,1459,1497,5291712
0400000US46,46,South Dakota,,2014,1000,Total - All Government Employment Functions,12738,52100518,6260,5344475,327367,14588,18998,57444993
0400000US46,46,South Dakota,,2014,1020,Financial Administration,430,2075014,17,30925,1696,440,447,2105939
0400000US46,46,South Dakota,,2014,1040,Other Government Administration,346,1429140,78,105534,7172,386,424,1534674
0400000US46,46,South Dakota,,2014,1060,Judicial and Legal,590,2751363,92,126053,7918,635,682,2877416
0400000US46,46,South Dakota,,2014,1100,Police Protection Total,329,1338214,19,28134,1274,337,348,1366348
0400000US46,46,South Dakota,,2014,1101,Police Protection - Persons with Power of Arrest       ,210,950726,0,0,0,210,210,950726
0400000US46,46,South Dakota,,2014,1102,Police Protection - Other ,119,387488,19,28134,1274,127,138,415622
0400000US46,46,South Dakota,,2014,1120,Fire Protection Total ,0,0,0,0,0,0,0,0
0400000US46,46,South Dakota,,2014,1121,Fire Protection - Firefighters,0,0,0,0,0,0,0,0
0400000US46,46,South Dakota,,2014,1122,Fire Protection - Other ,0,0,0,0,0,0,0,0
0400000US46,46,South Dakota,,2014,1140,Corrections,857,2890814,27,36082,2533,871,884,2926896
0400000US46,46,South Dakota,,2014,1160,Highways,963,3749102,66,69699,4661,989,1029,3818801
0400000US46,46,South Dakota,,2014,1180,Air Transportation,0,0,0,0,0,0,0,0
0400000US46,46,South Dakota,,2014,1200,Water Transport and Terminals       ,0,0,0,0,0,0,0,0
0400000US46,46,South Dakota,,2014,1220,Public Welfare,1653,5887463,134,217079,13551,1730,1787,6104542
0400000US46,46,South Dakota,,2014,1240,Health,513,2273565,143,417986,17520,613,656,2691551
0400000US46,46,South Dakota,,2014,1260,Hospitals,353,1066165,50,65412,4561,379,403,1131577
0400000US46,46,South Dakota,,2014,1280,Social Insurance Administration,246,752815,7,10091,658,250,253,762906
0400000US46,46,South Dakota,,2014,1300,Solid Waste Management,0,0,0,0,0,0,0,0
0400000US46,46,South Dakota,,2014,1320,Sewerage,0,0,0,0,0,0,0,0
0400000US46,46,South Dakota,,2014,1340,Parks and Recreation,122,412256,29,31275,2983,139,151,443531
0400000US46,46,South Dakota,,2014,1360,Housing and Community Development,0,0,0,0,0,0,0,0
0400000US46,46,South Dakota,,2014,1380,Natural Resources,776,2894914,458,489285,30597,948,1234,3384199
0400000US46,46,South Dakota,,2014,1400,Water Supply,0,0,0,0,0,0,0,0
0400000US46,46,South Dakota,,2014,1420,Electric Power,0,0,0,0,0,0,0,0
0400000US46,46,South Dakota,,2014,1440,Gas Supply,0,0,0,0,0,0,0,0
0400000US46,46,South Dakota,,2014,1460,Transit,0,0,0,0,0,0,0,0
0400000US46,46,South Dakota,,2014,1480,Education Total ,4783,21411809,5092,3659826,228502,6073,9875,25071635
0400000US46,46,South Dakota,,2014,1481,Education - Elementary and Secondary Total ,0,0,0,0,0,0,0,0
0400000US46,46,South Dakota,,2014,14811,Education - Elementary and Secondary Instructional             ,0,0,0,0,0,0,0,0
0400000US46,46,South Dakota,,2014,14812,Education - Elementary and Secondary Other ,0,0,0,0,0,0,0,0
0400000US46,46,South Dakota,,2014,1482,Education - Higher Education Total ,4431,20095194,5072,3627096,226283,5708,9503,23722290
0400000US46,46,South Dakota,,2014,14821,Education - Higher Education Instructional,1580,9820993,1572,2290762,99130,2140,3152,12111755
0400000US46,46,South Dakota,,2014,14822,Education - Higher Education Other ,2851,10274201,3500,1336334,127153,3568,6351,11610535
0400000US46,46,South Dakota,,2014,1483,Education - Other,352,1316615,20,32730,2219,365,372,1349345
0400000US46,46,South Dakota,,2014,1500,Libraries                          ,0,0,0,0,0,0,0,0
0400000US46,46,South Dakota,,2014,1560,State liquor stores,0,0,0,0,0,0,0,0
0400000US46,46,South Dakota,,2014,1580,All other and unallocable,777,3167884,48,57094,3741,798,825,3224978
0400000US47,47,Tennessee,,2014,1000,Total - All Government Employment Functions,70425,291924952,26794,24790527,1498527,79258,97219,316715479
0400000US47,47,Tennessee,,2014,1020,Financial Administration,3297,14460936,69,75061,5121,3329,3366,14535997
0400000US47,47,Tennessee,,2014,1040,Other Government Administration,752,3174235,13,8726,376,754,765,3182961
0400000US47,47,Tennessee,,2014,1060,Judicial and Legal,2483,13830647,40,56029,2033,2496,2523,13886676
0400000US47,47,Tennessee,,2014,1100,Police Protection Total,1752,8023496,15,27259,1441,1761,1767,8050755
0400000US47,47,Tennessee,,2014,1101,Police Protection - Persons with Power of Arrest       ,1356,6682700,8,8576,714,1360,1364,6691276
0400000US47,47,Tennessee,,2014,1102,Police Protection - Other ,396,1340796,7,18683,727,401,403,1359479
0400000US47,47,Tennessee,,2014,1120,Fire Protection Total ,0,0,0,0,0,0,0,0
0400000US47,47,Tennessee,,2014,1121,Fire Protection - Firefighters,0,0,0,0,0,0,0,0
0400000US47,47,Tennessee,,2014,1122,Fire Protection - Other ,0,0,0,0,0,0,0,0
0400000US47,47,Tennessee,,2014,1140,Corrections,7003,20990620,19,33360,2118,7016,7022,21023980
0400000US47,47,Tennessee,,2014,1160,Highways,3465,12156988,0,0,0,3465,3465,12156988
0400000US47,47,Tennessee,,2014,1180,Air Transportation,0,0,0,0,0,0,0,0
0400000US47,47,Tennessee,,2014,1200,Water Transport and Terminals       ,0,0,0,0,0,0,0,0
0400000US47,47,Tennessee,,2014,1220,Public Welfare,7633,25862348,5,5304,356,7635,7638,25867652
0400000US47,47,Tennessee,,2014,1240,Health,4141,17666153,115,368208,14461,4223,4256,18034361
0400000US47,47,Tennessee,,2014,1260,Hospitals,3671,13217839,110,454626,16438,3765,3781,13672465
0400000US47,47,Tennessee,,2014,1280,Social Insurance Administration,1013,3798560,93,143594,9328,1069,1106,3942154
0400000US47,47,Tennessee,,2014,1300,Solid Waste Management,0,0,0,0,0,0,0,0
0400000US47,47,Tennessee,,2014,1320,Sewerage,0,0,0,0,0,0,0,0
0400000US47,47,Tennessee,,2014,1340,Parks and Recreation,942,2314966,219,170734,17680,1049,1161,2485700
0400000US47,47,Tennessee,,2014,1360,Housing and Community Development,0,0,0,0,0,0,0,0
0400000US47,47,Tennessee,,2014,1380,Natural Resources,3409,13951785,495,740513,58925,3752,3904,14692298
0400000US47,47,Tennessee,,2014,1400,Water Supply,0,0,0,0,0,0,0,0
0400000US47,47,Tennessee,,2014,1420,Electric Power,0,0,0,0,0,0,0,0
0400000US47,47,Tennessee,,2014,1440,Gas Supply,0,0,0,0,0,0,0,0
0400000US47,47,Tennessee,,2014,1460,Transit,0,0,0,0,0,0,0,0
0400000US47,47,Tennessee,,2014,1480,Education Total ,28380,132963568,25449,22516403,1359999,36398,53829,155479971
0400000US47,47,Tennessee,,2014,1481,Education - Elementary and Secondary Total ,0,0,0,0,0,0,0,0
0400000US47,47,Tennessee,,2014,14811,Education - Elementary and Secondary Instructional             ,0,0,0,0,0,0,0,0
0400000US47,47,Tennessee,,2014,14812,Education - Elementary and Secondary Other ,0,0,0,0,0,0,0,0
0400000US47,47,Tennessee,,2014,1482,Education - Higher Education Total ,26513,125936227,25251,22277717,1348937,34464,51764,148213944
0400000US47,47,Tennessee,,2014,14821,Education - Higher Education Instructional,9100,58270532,10109,11924140,593097,12627,19209,70194672
0400000US47,47,Tennessee,,2014,14822,Education - Higher Education Other ,17413,67665695,15142,10353577,755840,21837,32555,78019272
0400000US47,47,Tennessee,,2014,1483,Education - Other,1867,7027341,198,238686,11062,1934,2065,7266027
0400000US47,47,Tennessee,,2014,1500,Libraries                          ,0,0,0,0,0,0,0,0
0400000US47,47,Tennessee,,2014,1560,State liquor stores,0,0,0,0,0,0,0,0
0400000US47,47,Tennessee,,2014,1580,All other and unallocable,2484,9512811,152,190710,10251,2546,2636,9703521
0400000US48,48,Texas,,2014,1000,Total - All Government Employment Functions,267657,1302844965,91732,127277726,6163194,302479,359389,1430122691
0400000US48,48,Texas,,2014,1020,Financial Administration,7509,35046090,344,438413,31144,7687,7853,35484503
0400000US48,48,Texas,,2014,1040,Other Government Administration,1914,9227734,401,460649,26052,2062,2315,9688383
0400000US48,48,Texas,,2014,1060,Judicial and Legal,5523,29540094,275,1557984,37365,5733,5798,31098078
0400000US48,48,Texas,,2014,1100,Police Protection Total,6762,34853415,74,81592,6247,6797,6836,34935007
0400000US48,48,Texas,,2014,1101,Police Protection - Persons with Power of Arrest       ,3546,22584285,0,0,0,3546,3546,22584285
0400000US48,48,Texas,,2014,1102,Police Protection - Other ,3216,12269130,74,81592,6247,3251,3290,12350722
0400000US48,48,Texas,,2014,1120,Fire Protection Total ,0,0,0,0,0,0,0,0
0400000US48,48,Texas,,2014,1121,Fire Protection - Firefighters,0,0,0,0,0,0,0,0
0400000US48,48,Texas,,2014,1122,Fire Protection - Other ,0,0,0,0,0,0,0,0
0400000US48,48,Texas,,2014,1140,Corrections,39593,122177975,603,857563,54085,39899,40196,123035538
0400000US48,48,Texas,,2014,1160,Highways,12697,54445215,288,790027,20844,12815,12985,55235242
0400000US48,48,Texas,,2014,1180,Air Transportation,0,0,0,0,0,0,0,0
0400000US48,48,Texas,,2014,1200,Water Transport and Terminals       ,0,0,0,0,0,0,0,0
0400000US48,48,Texas,,2014,1220,Public Welfare,23762,77127324,57,134921,5797,23795,23819,77262245
0400000US48,48,Texas,,2014,1240,Health,18536,84353230,428,1379629,49944,18818,18964,85732859
0400000US48,48,Texas,,2014,1260,Hospitals,21412,103330414,2761,11286030,317622,23206,24173,114616444
0400000US48,48,Texas,,2014,1280,Social Insurance Administration,3866,14153948,33,70317,3094,3884,3899,14224265
0400000US48,48,Texas,,2014,1300,Solid Waste Management,0,0,0,0,0,0,0,0
0400000US48,48,Texas,,2014,1320,Sewerage,0,0,0,0,0,0,0,0
0400000US48,48,Texas,,2014,1340,Parks and Recreation,1120,3619399,127,158497,14081,1200,1247,3777896
0400000US48,48,Texas,,2014,1360,Housing and Community Development,0,0,0,0,0,0,0,0
0400000US48,48,Texas,,2014,1380,Natural Resources,9733,44902791,2631,2883138,154103,10603,12364,47785929
0400000US48,48,Texas,,2014,1400,Water Supply,0,0,0,0,0,0,0,0
0400000US48,48,Texas,,2014,1420,Electric Power,0,0,0,0,0,0,0,0
0400000US48,48,Texas,,2014,1440,Gas Supply,0,0,0,0,0,0,0,0
0400000US48,48,Texas,,2014,1460,Transit,0,0,0,0,0,0,0,0
0400000US48,48,Texas,,2014,1480,Education Total ,107790,654574932,83367,106618972,5418908,138406,191157,761193904
0400000US48,48,Texas,,2014,1481,Education - Elementary and Secondary Total ,16,77140,5,6388,252,18,21,83528
0400000US48,48,Texas,,2014,14811,Education - Elementary and Secondary Instructional             ,14,69977,5,6388,252,16,19,76365
0400000US48,48,Texas,,2014,14812,Education - Elementary and Secondary Other ,2,7163,0,0,0,2,2,7163
0400000US48,48,Texas,,2014,1482,Education - Higher Education Total ,103606,634792525,82912,105503185,5373243,133963,186518,740295710
0400000US48,48,Texas,,2014,14821,Education - Higher Education Instructional,26428,273439811,30778,53750815,2052949,38027,57206,327190626
0400000US48,48,Texas,,2014,14822,Education - Higher Education Other ,77178,361352714,52134,51752370,3320294,95936,129312,413105084
0400000US48,48,Texas,,2014,1483,Education - Other,4168,19705267,450,1109399,45413,4425,4618,20814666
0400000US48,48,Texas,,2014,1500,Libraries                          ,0,0,0,0,0,0,0,0
0400000US48,48,Texas,,2014,1560,State liquor stores,0,0,0,0,0,0,0,0
0400000US48,48,Texas,,2014,1580,All other and unallocable,7440,35492404,343,559994,23908,7574,7783,36052398
0400000US49,49,Utah,,2014,1000,Total - All Government Employment Functions,46059,215838443,26066,28798768,1411771,54038,72125,244637211
0400000US49,49,Utah,,2014,1020,Financial Administration,2372,10478455,91,185626,9283,2425,2463,10664081
0400000US49,49,Utah,,2014,1040,Other Government Administration,393,2012825,170,313043,17057,489,563,2325868
0400000US49,49,Utah,,2014,1060,Judicial and Legal,1467,7298379,144,235047,13585,1544,1611,7533426
0400000US49,49,Utah,,2014,1100,Police Protection Total,830,3449045,111,121732,6738,868,941,3570777
0400000US49,49,Utah,,2014,1101,Police Protection - Persons with Power of Arrest       ,446,2000251,0,0,0,446,446,2000251
0400000US49,49,Utah,,2014,1102,Police Protection - Other ,384,1448794,111,121732,6738,422,495,1570526
0400000US49,49,Utah,,2014,1120,Fire Protection Total ,0,0,0,0,0,0,0,0
0400000US49,49,Utah,,2014,1121,Fire Protection - Firefighters,0,0,0,0,0,0,0,0
0400000US49,49,Utah,,2014,1122,Fire Protection - Other ,0,0,0,0,0,0,0,0
0400000US49,49,Utah,,2014,1140,Corrections,3093,11047003,103,115240,7916,3138,3196,11162243
0400000US49,49,Utah,,2014,1160,Highways,1545,6737489,30,57618,3483,1565,1575,6795107
0400000US49,49,Utah,,2014,1180,Air Transportation,0,0,0,0,0,0,0,0
0400000US49,49,Utah,,2014,1200,Water Transport and Terminals       ,0,0,0,0,0,0,0,0
0400000US49,49,Utah,,2014,1220,Public Welfare,2668,9264682,137,283556,14455,2750,2805,9548238
0400000US49,49,Utah,,2014,1240,Health,1761,7234425,208,429555,18108,1864,1969,7663980
0400000US49,49,Utah,,2014,1260,Hospitals,8421,34472920,1172,2075496,78278,8863,9593,36548416
0400000US49,49,Utah,,2014,1280,Social Insurance Administration,954,3568687,31,81027,3426,973,985,3649714
0400000US49,49,Utah,,2014,1300,Solid Waste Management,0,0,0,0,0,0,0,0
0400000US49,49,Utah,,2014,1320,Sewerage,0,0,0,0,0,0,0,0
0400000US49,49,Utah,,2014,1340,Parks and Recreation,261,838085,45,48548,4320,286,306,886633
0400000US49,49,Utah,,2014,1360,Housing and Community Development,0,0,0,0,0,0,0,0
0400000US49,49,Utah,,2014,1380,Natural Resources,1177,4690800,211,249152,15995,1267,1388,4939952
0400000US49,49,Utah,,2014,1400,Water Supply,0,0,0,0,0,0,0,0
0400000US49,49,Utah,,2014,1420,Electric Power,0,0,0,0,0,0,0,0
0400000US49,49,Utah,,2014,1440,Gas Supply,0,0,0,0,0,0,0,0
0400000US49,49,Utah,,2014,1460,Transit,0,0,0,0,0,0,0,0
0400000US49,49,Utah,,2014,1480,Education Total ,19340,107896412,23213,24188624,1188116,26053,42553,132085036
0400000US49,49,Utah,,2014,1481,Education - Elementary and Secondary Total ,0,0,0,0,0,0,0,0
0400000US49,49,Utah,,2014,14811,Education - Elementary and Secondary Instructional             ,0,0,0,0,0,0,0,0
0400000US49,49,Utah,,2014,14812,Education - Elementary and Secondary Other ,0,0,0,0,0,0,0,0
0400000US49,49,Utah,,2014,1482,Education - Higher Education Total ,17811,101447320,22135,22879539,1113664,24103,39946,124326859
0400000US49,49,Utah,,2014,14821,Education - Higher Education Instructional,5610,50484114,8505,13366451,414982,7955,14115,63850565
0400000US49,49,Utah,,2014,14822,Education - Higher Education Other ,12201,50963206,13630,9513088,698682,16148,25831,60476294
0400000US49,49,Utah,,2014,1483,Education - Other,1529,6449092,1078,1309085,74452,1950,2607,7758177
0400000US49,49,Utah,,2014,1500,Libraries                          ,0,0,0,0,0,0,0,0
0400000US49,49,Utah,,2014,1560,State liquor stores,303,716538,244,174007,18968,410,547,890545
0400000US49,49,Utah,,2014,1580,All other and unallocable,1474,6132698,156,240497,12043,1543,1630,6373195
0400000US50,50,Vermont,,2014,1000,Total - All Government Employment Functions,13289,65704293,4150,6853392,203587,14483,17439,72557685
0400000US50,50,Vermont,,2014,1020,Financial Administration,639,3079361,19,17366,1030,644,658,3096727
0400000US50,50,Vermont,,2014,1040,Other Government Administration,472,2009757,212,545760,3413,490,684,2555517
0400000US50,50,Vermont,,2014,1060,Judicial and Legal,681,3343815,22,14151,686,685,703,3357966
0400000US50,50,Vermont,,2014,1100,Police Protection Total,638,3536407,72,42065,2491,652,710,3578472
0400000US50,50,Vermont,,2014,1101,Police Protection - Persons with Power of Arrest       ,309,2110232,12,6056,390,311,321,2116288
0400000US50,50,Vermont,,2014,1102,Police Protection - Other ,329,1426175,60,36009,2101,341,389,1462184
0400000US50,50,Vermont,,2014,1120,Fire Protection Total ,0,0,0,0,0,0,0,0
0400000US50,50,Vermont,,2014,1121,Fire Protection - Firefighters,0,0,0,0,0,0,0,0
0400000US50,50,Vermont,,2014,1122,Fire Protection - Other ,0,0,0,0,0,0,0,0
0400000US50,50,Vermont,,2014,1140,Corrections,1085,4776270,9,9736,306,1087,1094,4786006
0400000US50,50,Vermont,,2014,1160,Highways,1069,5135535,5,1902,100,1070,1074,5137437
0400000US50,50,Vermont,,2014,1180,Air Transportation,0,0,0,0,0,0,0,0
0400000US50,50,Vermont,,2014,1200,Water Transport and Terminals       ,0,0,0,0,0,0,0,0
0400000US50,50,Vermont,,2014,1220,Public Welfare,1535,6841030,39,39222,1400,1543,1574,6880252
0400000US50,50,Vermont,,2014,1240,Health,508,2354078,35,14258,974,514,543,2368336
0400000US50,50,Vermont,,2014,1260,Hospitals,193,897838,6,10325,244,194,199,908163
0400000US50,50,Vermont,,2014,1280,Social Insurance Administration,271,1127955,5,2662,120,272,276,1130617
0400000US50,50,Vermont,,2014,1300,Solid Waste Management,0,0,0,0,0,0,0,0
0400000US50,50,Vermont,,2014,1320,Sewerage,0,0,0,0,0,0,0,0
0400000US50,50,Vermont,,2014,1340,Parks and Recreation,121,535952,4,1918,124,122,125,537870
0400000US50,50,Vermont,,2014,1360,Housing and Community Development,0,0,0,0,0,0,0,0
0400000US50,50,Vermont,,2014,1380,Natural Resources,606,2995883,15,13816,574,610,621,3009699
0400000US50,50,Vermont,,2014,1400,Water Supply,0,0,0,0,0,0,0,0
0400000US50,50,Vermont,,2014,1420,Electric Power,0,0,0,0,0,0,0,0
0400000US50,50,Vermont,,2014,1440,Gas Supply,0,0,0,0,0,0,0,0
0400000US50,50,Vermont,,2014,1460,Transit,0,0,0,0,0,0,0,0
0400000US50,50,Vermont,,2014,1480,Education Total ,4237,23067680,3648,6088405,189286,5351,7885,29156085
0400000US50,50,Vermont,,2014,1481,Education - Elementary and Secondary Total ,0,0,0,0,0,0,0,0
0400000US50,50,Vermont,,2014,14811,Education - Elementary and Secondary Instructional             ,0,0,0,0,0,0,0,0
0400000US50,50,Vermont,,2014,14812,Education - Elementary and Secondary Other ,0,0,0,0,0,0,0,0
0400000US50,50,Vermont,,2014,1482,Education - Higher Education Total ,3807,21015332,3636,6066912,188264,4915,7443,27082244
0400000US50,50,Vermont,,2014,14821,Education - Higher Education Instructional,952,8590999,1215,2328189,50464,1246,2167,10919188
0400000US50,50,Vermont,,2014,14822,Education - Higher Education Other ,2855,12424333,2421,3738723,137800,3669,5276,16163056
0400000US50,50,Vermont,,2014,1483,Education - Other,430,2052348,12,21493,1022,436,442,2073841
0400000US50,50,Vermont,,2014,1500,Libraries                          ,0,0,0,0,0,0,0,0
0400000US50,50,Vermont,,2014,1560,State liquor stores,53,246784,0,0,0,53,53,246784
0400000US50,50,Vermont,,2014,1580,All other and unallocable,1181,5755948,59,51806,2839,1196,1240,5807754
0400000US51,51,Virginia,,2014,1000,Total - All Government Employment Functions,107294,518989058,59792,67839677,3449305,126789,167086,586828735
0400000US51,51,Virginia,,2014,1020,Financial Administration,3997,18197166,535,733520,59533,4332,4532,18930686
0400000US51,51,Virginia,,2014,1040,Other Government Administration,550,3109031,562,884867,38724,776,1112,3993898
0400000US51,51,Virginia,,2014,1060,Judicial and Legal,3725,18031748,331,413772,14468,3806,4056,18445520
0400000US51,51,Virginia,,2014,1100,Police Protection Total,3130,14990797,152,258525,12895,3203,3282,15249322
0400000US51,51,Virginia,,2014,1101,Police Protection - Persons with Power of Arrest       ,2361,12189305,14,27006,1402,2369,2375,12216311
0400000US51,51,Virginia,,2014,1102,Police Protection - Other ,769,2801492,138,231519,11493,834,907,3033011
0400000US51,51,Virginia,,2014,1120,Fire Protection Total ,0,0,0,0,0,0,0,0
0400000US51,51,Virginia,,2014,1121,Fire Protection - Firefighters,0,0,0,0,0,0,0,0
0400000US51,51,Virginia,,2014,1122,Fire Protection - Other ,0,0,0,0,0,0,0,0
0400000US51,51,Virginia,,2014,1140,Corrections,13950,46544488,405,595198,35630,14151,14355,47139686
0400000US51,51,Virginia,,2014,1160,Highways,7259,35468890,295,527128,23252,7391,7554,35996018
0400000US51,51,Virginia,,2014,1180,Air Transportation,0,0,0,0,0,0,0,0
0400000US51,51,Virginia,,2014,1200,Water Transport and Terminals       ,84,536630,0,0,0,84,84,536630
0400000US51,51,Virginia,,2014,1220,Public Welfare,2748,11881409,310,538813,26708,2898,3058,12420222
0400000US51,51,Virginia,,2014,1240,Health,5078,21103142,618,893748,49806,5359,5696,21996890
0400000US51,51,Virginia,,2014,1260,Hospitals,14002,59765879,2699,5538344,218654,15239,16701,65304223
0400000US51,51,Virginia,,2014,1280,Social Insurance Administration,1152,4530088,398,683902,39088,1373,1550,5213990
0400000US51,51,Virginia,,2014,1300,Solid Waste Management,0,0,0,0,0,0,0,0
0400000US51,51,Virginia,,2014,1320,Sewerage,0,0,0,0,0,0,0,0
0400000US51,51,Virginia,,2014,1340,Parks and Recreation,655,2489804,953,800328,68248,1040,1608,3290132
0400000US51,51,Virginia,,2014,1360,Housing and Community Development,0,0,0,0,0,0,0,0
0400000US51,51,Virginia,,2014,1380,Natural Resources,2241,11603221,702,1031276,74231,2659,2943,12634497
0400000US51,51,Virginia,,2014,1400,Water Supply,0,0,0,0,0,0,0,0
0400000US51,51,Virginia,,2014,1420,Electric Power,0,0,0,0,0,0,0,0
0400000US51,51,Virginia,,2014,1440,Gas Supply,0,0,0,0,0,0,0,0
0400000US51,51,Virginia,,2014,1460,Transit,0,0,0,0,0,0,0,0
0400000US51,51,Virginia,,2014,1480,Education Total ,44280,249107919,48900,52135454,2562163,58758,93180,301243373
0400000US51,51,Virginia,,2014,1481,Education - Elementary and Secondary Total ,2,16416,0,0,0,2,2,16416
0400000US51,51,Virginia,,2014,14811,Education - Elementary and Secondary Instructional             ,0,0,0,0,0,0,0,0
0400000US51,51,Virginia,,2014,14812,Education - Elementary and Secondary Other ,2,16416,0,0,0,2,2,16416
0400000US51,51,Virginia,,2014,1482,Education - Higher Education Total ,42373,239550379,48490,51428418,2526505,56649,90863,290978797
0400000US51,51,Virginia,,2014,14821,Education - Higher Education Instructional,15644,120308224,15135,22915059,685728,19519,30779,143223283
0400000US51,51,Virginia,,2014,14822,Education - Higher Education Other ,26729,119242155,33355,28513359,1840777,37130,60084,147755514
0400000US51,51,Virginia,,2014,1483,Education - Other,1905,9541124,410,707036,35658,2107,2315,10248160
0400000US51,51,Virginia,,2014,1500,Libraries                          ,0,0,0,0,0,0,0,0
0400000US51,51,Virginia,,2014,1560,State liquor stores,875,3246712,2246,2123378,190764,1953,3121,5370090
0400000US51,51,Virginia,,2014,1580,All other and unallocable,3568,18382134,686,681424,35141,3767,4254,19063558
0400000US53,53,Washington,,2014,1000,Total - All Government Employment Functions,99076,511840089,53857,91753035,3687950,119914,152933,603593124
0400000US53,53,Washington,,2014,1020,Financial Administration,2660,13804148,201,802620,19744,2771,2861,14606768
0400000US53,53,Washington,,2014,1040,Other Government Administration,569,2810788,394,1508785,49489,849,963,4319573
0400000US53,53,Washington,,2014,1060,Judicial and Legal,1777,10382880,210,1063696,22624,1905,1987,11446576
0400000US53,53,Washington,,2014,1100,Police Protection Total,2211,10952520,38,119464,1954,2222,2249,11071984
0400000US53,53,Washington,,2014,1101,Police Protection - Persons with Power of Arrest       ,815,5436242,0,0,0,815,815,5436242
0400000US53,53,Washington,,2014,1102,Police Protection - Other ,1396,5516278,38,119464,1954,1407,1434,5635742
0400000US53,53,Washington,,2014,1120,Fire Protection Total ,0,0,0,0,0,0,0,0
0400000US53,53,Washington,,2014,1121,Fire Protection - Firefighters,0,0,0,0,0,0,0,0
0400000US53,53,Washington,,2014,1122,Fire Protection - Other ,0,0,0,0,0,0,0,0
0400000US53,53,Washington,,2014,1140,Corrections,7388,30642730,1457,5173798,206178,8553,8845,35816528
0400000US53,53,Washington,,2014,1160,Highways,6565,34319328,161,379038,8946,6616,6726,34698366
0400000US53,53,Washington,,2014,1180,Air Transportation,0,0,0,0,0,0,0,0
0400000US53,53,Washington,,2014,1200,Water Transport and Terminals       ,2,12712,4,600,6,2,6,13312
0400000US53,53,Washington,,2014,1220,Public Welfare,9656,42073264,1169,3787802,153082,10521,10825,45861066
0400000US53,53,Washington,,2014,1240,Health,5517,23961530,1026,3153490,138352,6298,6543,27115020
0400000US53,53,Washington,,2014,1260,Hospitals,8442,47832984,3618,14752640,326840,10289,12060,62585624
0400000US53,53,Washington,,2014,1280,Social Insurance Administration,3417,15504896,324,1209518,40442,3646,3741,16714414
0400000US53,53,Washington,,2014,1300,Solid Waste Management,507,2706138,65,287386,8930,557,572,2993524
0400000US53,53,Washington,,2014,1320,Sewerage,0,0,0,0,0,0,0,0
0400000US53,53,Washington,,2014,1340,Parks and Recreation,457,2170622,102,298254,12026,524,559,2468876
0400000US53,53,Washington,,2014,1360,Housing and Community Development,51,308324,14,29164,511,54,65,337488
0400000US53,53,Washington,,2014,1380,Natural Resources,4298,19616104,930,2089375,86976,4790,5228,21705479
0400000US53,53,Washington,,2014,1400,Water Supply,0,0,0,0,0,0,0,0
0400000US53,53,Washington,,2014,1420,Electric Power,0,0,0,0,0,0,0,0
0400000US53,53,Washington,,2014,1440,Gas Supply,0,0,0,0,0,0,0,0
0400000US53,53,Washington,,2014,1460,Transit,0,0,0,0,0,0,0,0
0400000US53,53,Washington,,2014,1480,Education Total ,41983,236738753,43542,54916662,2535877,56311,85525,291655415
0400000US53,53,Washington,,2014,1481,Education - Elementary and Secondary Total ,0,0,0,0,0,0,0,0
0400000US53,53,Washington,,2014,14811,Education - Elementary and Secondary Instructional             ,0,0,0,0,0,0,0,0
0400000US53,53,Washington,,2014,14812,Education - Elementary and Secondary Other ,0,0,0,0,0,0,0,0
0400000US53,53,Washington,,2014,1482,Education - Higher Education Total ,40114,227728605,42839,53590986,2481905,54138,82953,281319591
0400000US53,53,Washington,,2014,14821,Education - Higher Education Instructional,13053,96580211,9233,25796832,546210,16140,22286,122377043
0400000US53,53,Washington,,2014,14822,Education - Higher Education Other ,27061,131148394,33606,27794154,1935695,37998,60667,158942548
0400000US53,53,Washington,,2014,1483,Education - Other,1869,9010148,703,1325676,53972,2173,2572,10335824
0400000US53,53,Washington,,2014,1500,Libraries                          ,0,0,0,0,0,0,0,0
0400000US53,53,Washington,,2014,1560,State liquor stores,92,480614,6,20936,580,95,98,501550
0400000US53,53,Washington,,2014,1580,All other and unallocable,3484,17521754,596,2159807,75393,3911,4080,19681561
0400000US54,54,West Virginia,,2014,1000,Total - All Government Employment Functions,36579,134872224,12089,11143727,621559,40281,48668,146015951
0400000US54,54,West Virginia,,2014,1020,Financial Administration,1894,5779116,73,115956,6307,1929,1967,5895072
0400000US54,54,West Virginia,,2014,1040,Other Government Administration,235,883778,238,596333,19937,355,473,1480111
0400000US54,54,West Virginia,,2014,1060,Judicial and Legal,1588,7373152,42,117467,4898,1615,1630,7490619
0400000US54,54,West Virginia,,2014,1100,Police Protection Total,1021,4152734,24,21120,1682,1031,1045,4173854
0400000US54,54,West Virginia,,2014,1101,Police Protection - Persons with Power of Arrest       ,646,3188600,0,0,0,646,646,3188600
0400000US54,54,West Virginia,,2014,1102,Police Protection - Other ,375,964134,24,21120,1682,385,399,985254
0400000US54,54,West Virginia,,2014,1120,Fire Protection Total ,0,0,0,0,0,0,0,0
0400000US54,54,West Virginia,,2014,1121,Fire Protection - Firefighters,0,0,0,0,0,0,0,0
0400000US54,54,West Virginia,,2014,1122,Fire Protection - Other ,0,0,0,0,0,0,0,0
0400000US54,54,West Virginia,,2014,1140,Corrections,3363,8327294,26,39652,3674,3383,3389,8366946
0400000US54,54,West Virginia,,2014,1160,Highways,5138,15325216,30,51117,4216,5162,5168,15376333
0400000US54,54,West Virginia,,2014,1180,Air Transportation,3,12118,0,0,0,3,3,12118
0400000US54,54,West Virginia,,2014,1200,Water Transport and Terminals       ,2,6972,0,0,0,2,2,6972
0400000US54,54,West Virginia,,2014,1220,Public Welfare,3439,8994365,91,144654,11142,3502,3530,9139019
0400000US54,54,West Virginia,,2014,1240,Health,787,2637500,64,97832,4680,813,851,2735332
0400000US54,54,West Virginia,,2014,1260,Hospitals,1640,4296856,82,88725,6722,1678,1722,4385581
0400000US54,54,West Virginia,,2014,1280,Social Insurance Administration,544,1652016,71,73262,5448,576,615,1725278
0400000US54,54,West Virginia,,2014,1300,Solid Waste Management,11,42516,0,0,0,11,11,42516
0400000US54,54,West Virginia,,2014,1320,Sewerage,0,0,0,0,0,0,0,0
0400000US54,54,West Virginia,,2014,1340,Parks and Recreation,384,817678,381,289922,37570,596,765,1107600
0400000US54,54,West Virginia,,2014,1360,Housing and Community Development,0,0,0,0,0,0,0,0
0400000US54,54,West Virginia,,2014,1380,Natural Resources,1838,6534823,155,102341,9131,1892,1993,6637164
0400000US54,54,West Virginia,,2014,1400,Water Supply,0,0,0,0,0,0,0,0
0400000US54,54,West Virginia,,2014,1420,Electric Power,0,0,0,0,0,0,0,0
0400000US54,54,West Virginia,,2014,1440,Gas Supply,0,0,0,0,0,0,0,0
0400000US54,54,West Virginia,,2014,1460,Transit,9,33130,0,0,0,9,9,33130
0400000US54,54,West Virginia,,2014,1480,Education Total ,12365,60089108,10660,9294753,499034,15364,23025,69383861
0400000US54,54,West Virginia,,2014,1481,Education - Elementary and Secondary Total ,0,0,0,0,0,0,0,0
0400000US54,54,West Virginia,,2014,14811,Education - Elementary and Secondary Instructional             ,0,0,0,0,0,0,0,0
0400000US54,54,West Virginia,,2014,14812,Education - Elementary and Secondary Other ,0,0,0,0,0,0,0,0
0400000US54,54,West Virginia,,2014,1482,Education - Higher Education Total ,11159,55153682,10524,9095251,492408,14118,21683,64248933
0400000US54,54,West Virginia,,2014,14821,Education - Higher Education Instructional,4135,27262718,4399,5835151,180872,5219,8534,33097869
0400000US54,54,West Virginia,,2014,14822,Education - Higher Education Other ,7024,27890964,6125,3260100,311536,8899,13149,31151064
0400000US54,54,West Virginia,,2014,1483,Education - Other,1206,4935426,136,199502,6626,1246,1342,5134928
0400000US54,54,West Virginia,,2014,1500,Libraries                          ,0,0,0,0,0,0,0,0
0400000US54,54,West Virginia,,2014,1560,State liquor stores,49,133624,2,3262,270,51,51,136886
0400000US54,54,West Virginia,,2014,1580,All other and unallocable,2269,7780228,150,107331,6848,2309,2419,7887559
0400000US55,55,Wisconsin,,2014,1000,Total - All Government Employment Functions,57683,295624204,49807,48709345,2631640,72551,107490,344333549
0400000US55,55,Wisconsin,,2014,1020,Financial Administration,2260,10932926,277,504213,31841,2439,2537,11437139
0400000US55,55,Wisconsin,,2014,1040,Other Government Administration,501,2341205,263,702662,33978,692,764,3043867
0400000US55,55,Wisconsin,,2014,1060,Judicial and Legal,1963,13060198,273,881737,31610,2142,2236,13941935
0400000US55,55,Wisconsin,,2014,1100,Police Protection Total,868,4339456,27,52808,2631,884,895,4392264
0400000US55,55,Wisconsin,,2014,1101,Police Protection - Persons with Power of Arrest       ,525,2829966,3,2520,102,526,528,2832486
0400000US55,55,Wisconsin,,2014,1102,Police Protection - Other ,343,1509490,24,50288,2529,358,367,1559778
0400000US55,55,Wisconsin,,2014,1120,Fire Protection Total ,0,0,0,0,0,0,0,0
0400000US55,55,Wisconsin,,2014,1121,Fire Protection - Firefighters,0,0,0,0,0,0,0,0
0400000US55,55,Wisconsin,,2014,1122,Fire Protection - Other ,0,0,0,0,0,0,0,0
0400000US55,55,Wisconsin,,2014,1140,Corrections,9109,39002327,686,2172750,72451,9518,9795,41175077
0400000US55,55,Wisconsin,,2014,1160,Highways,1434,7863704,65,117003,5587,1466,1499,7980707
0400000US55,55,Wisconsin,,2014,1180,Air Transportation,0,0,0,0,0,0,0,0
0400000US55,55,Wisconsin,,2014,1200,Water Transport and Terminals       ,0,0,0,0,0,0,0,0
0400000US55,55,Wisconsin,,2014,1220,Public Welfare,1941,8374062,335,794559,42663,2182,2276,9168621
0400000US55,55,Wisconsin,,2014,1240,Health,1484,7475063,280,666979,28141,1643,1764,8142042
0400000US55,55,Wisconsin,,2014,1260,Hospitals,3323,13508354,537,1453652,56976,3645,3860,14962006
0400000US55,55,Wisconsin,,2014,1280,Social Insurance Administration,895,3762341,76,164145,9947,951,971,3926486
0400000US55,55,Wisconsin,,2014,1300,Solid Waste Management,0,0,0,0,0,0,0,0
0400000US55,55,Wisconsin,,2014,1320,Sewerage,0,0,0,0,0,0,0,0
0400000US55,55,Wisconsin,,2014,1340,Parks and Recreation,110,480810,53,60158,3525,130,163,540968
0400000US55,55,Wisconsin,,2014,1360,Housing and Community Development,0,0,0,0,0,0,0,0
0400000US55,55,Wisconsin,,2014,1380,Natural Resources,1952,8638174,904,1121460,65363,2321,2856,9759634
0400000US55,55,Wisconsin,,2014,1400,Water Supply,0,0,0,0,0,0,0,0
0400000US55,55,Wisconsin,,2014,1420,Electric Power,0,0,0,0,0,0,0,0
0400000US55,55,Wisconsin,,2014,1440,Gas Supply,0,0,0,0,0,0,0,0
0400000US55,55,Wisconsin,,2014,1460,Transit,0,0,0,0,0,0,0,0
0400000US55,55,Wisconsin,,2014,1480,Education Total ,27311,152642688,45322,38678478,2181780,39639,72633,191321166
0400000US55,55,Wisconsin,,2014,1481,Education - Elementary and Secondary Total ,0,0,0,0,0,0,0,0
0400000US55,55,Wisconsin,,2014,14811,Education - Elementary and Secondary Instructional             ,0,0,0,0,0,0,0,0
0400000US55,55,Wisconsin,,2014,14812,Education - Elementary and Secondary Other ,0,0,0,0,0,0,0,0
0400000US55,55,Wisconsin,,2014,1482,Education - Higher Education Total ,26312,147884531,45106,38305549,2164444,38541,71418,186190080
0400000US55,55,Wisconsin,,2014,14821,Education - Higher Education Instructional,8898,61696375,12411,14642174,698220,12843,21309,76338549
0400000US55,55,Wisconsin,,2014,14822,Education - Higher Education Other ,17414,86188156,32695,23663375,1466224,25698,50109,109851531
0400000US55,55,Wisconsin,,2014,1483,Education - Other,999,4758157,216,372929,17336,1098,1215,5131086
0400000US55,55,Wisconsin,,2014,1500,Libraries                          ,0,0,0,0,0,0,0,0
0400000US55,55,Wisconsin,,2014,1560,State liquor stores,0,0,0,0,0,0,0,0
0400000US55,55,Wisconsin,,2014,1580,All other and unallocable,4532,23202896,709,1338741,65147,4899,5241,24541637
0400000US56,56,Wyoming,,2014,1000,Total - All Government Employment Functions,12361,53365462,3415,3045241,199383,13484,15776,56410703
0400000US56,56,Wyoming,,2014,1020,Financial Administration,750,3724877,6,11480,530,752,756,3736357
0400000US56,56,Wyoming,,2014,1040,Other Government Administration,134,769785,91,149793,8425,181,225,919578
0400000US56,56,Wyoming,,2014,1060,Judicial and Legal,530,2860876,35,120988,3346,548,565,2981864
0400000US56,56,Wyoming,,2014,1100,Police Protection Total,276,1273765,0,0,0,276,276,1273765
0400000US56,56,Wyoming,,2014,1101,Police Protection - Persons with Power of Arrest       ,182,756634,0,0,0,182,182,756634
0400000US56,56,Wyoming,,2014,1102,Police Protection - Other ,94,517131,0,0,0,94,94,517131
0400000US56,56,Wyoming,,2014,1120,Fire Protection Total ,0,0,0,0,0,0,0,0
0400000US56,56,Wyoming,,2014,1121,Fire Protection - Firefighters,0,0,0,0,0,0,0,0
0400000US56,56,Wyoming,,2014,1122,Fire Protection - Other ,0,0,0,0,0,0,0,0
0400000US56,56,Wyoming,,2014,1140,Corrections,1327,4711611,2,2720,177,1328,1329,4714331
0400000US56,56,Wyoming,,2014,1160,Highways,1736,6713485,79,147246,10415,1795,1815,6860731
0400000US56,56,Wyoming,,2014,1180,Air Transportation,0,0,0,0,0,0,0,0
0400000US56,56,Wyoming,,2014,1200,Water Transport and Terminals       ,0,0,0,0,0,0,0,0
0400000US56,56,Wyoming,,2014,1220,Public Welfare,566,2204101,2,2032,177,567,568,2206133
0400000US56,56,Wyoming,,2014,1240,Health,879,4048516,76,140532,7062,919,955,4189048
0400000US56,56,Wyoming,,2014,1260,Hospitals,725,2448018,15,23294,1409,733,740,2471312
0400000US56,56,Wyoming,,2014,1280,Social Insurance Administration,124,475014,0,0,0,124,124,475014
0400000US56,56,Wyoming,,2014,1300,Solid Waste Management,0,0,0,0,0,0,0,0
0400000US56,56,Wyoming,,2014,1320,Sewerage,0,0,0,0,0,0,0,0
0400000US56,56,Wyoming,,2014,1340,Parks and Recreation,195,856690,57,66801,4681,221,252,923491
0400000US56,56,Wyoming,,2014,1360,Housing and Community Development,0,0,0,0,0,0,0,0
0400000US56,56,Wyoming,,2014,1380,Natural Resources,941,4195167,30,34878,2136,953,971,4230045
0400000US56,56,Wyoming,,2014,1400,Water Supply,0,0,0,0,0,0,0,0
0400000US56,56,Wyoming,,2014,1420,Electric Power,0,0,0,0,0,0,0,0
0400000US56,56,Wyoming,,2014,1440,Gas Supply,0,0,0,0,0,0,0,0
0400000US56,56,Wyoming,,2014,1460,Transit,0,0,0,0,0,0,0,0
0400000US56,56,Wyoming,,2014,1480,Education Total ,3249,15142913,2993,2302642,158437,4144,6242,17445555
0400000US56,56,Wyoming,,2014,1481,Education - Elementary and Secondary Total ,0,0,0,0,0,0,0,0
0400000US56,56,Wyoming,,2014,14811,Education - Elementary and Secondary Instructional             ,0,0,0,0,0,0,0,0
0400000US56,56,Wyoming,,2014,14812,Education - Elementary and Secondary Other ,0,0,0,0,0,0,0,0
0400000US56,56,Wyoming,,2014,1482,Education - Higher Education Total ,3036,14021615,2989,2297696,158084,3929,6025,16319311
0400000US56,56,Wyoming,,2014,14821,Education - Higher Education Instructional,1056,6712475,850,989777,47020,1322,1906,7702252
0400000US56,56,Wyoming,,2014,14822,Education - Higher Education Other ,1980,7309140,2139,1307919,111064,2607,4119,8617059
0400000US56,56,Wyoming,,2014,1483,Education - Other,213,1121298,4,4946,353,215,217,1126244
0400000US56,56,Wyoming,,2014,1500,Libraries                          ,0,0,0,0,0,0,0,0
0400000US56,56,Wyoming,,2014,1560,State liquor stores,37,141443,0,0,0,37,37,141443
0400000US56,56,Wyoming,,2014,1580,All other and unallocable,892,3799201,29,42835,2588,906,921,3842036
