GEO.id,GEO.id2,GEO.display-label,GEO.annotation.id,YEAR.id,GOVEMPFUNCT.id,GOVEMPFUNCT.display-label,EMPFT,PAYANNFT,EMPPT,PAYANNPT,HRSPT,EMPFTE,EMP,PAYANN
0100000US,,United States,,2013,1000,Total - All Government Employment Functions,3715174,18268437317,1588537,2204353757,104656737,4315482,5303711,20472791074
0100000US,,United States,,2013,1020,Financial Administration,161936,750573643,9251,19206734,973392,167533,171187,769780377
0100000US,,United States,,2013,1040,Other Government Administration,47018,224285086,10827,22588399,934598,52403,57845,246873485
0100000US,,United States,,2013,1060,Judicial and Legal,168705,909160034,9299,22611295,810326,173332,178004,931771329
0100000US,,United States,,2013,1100,Police Protection Total,99154,559999410,2817,4336539,189895,100242,101971,564335949
0100000US,,United States,,2013,1101,Police Protection - Persons with Power of Arrest       ,63371,413070643,593,696968,23425,63502,63964,413767611
0100000US,,United States,,2013,1102,Police Protection - Other ,35783,146928767,2224,3639571,166470,36740,38007,150568338
0100000US,,United States,,2013,1120,Fire Protection Total ,0,0,0,0,0,0,0,0
0100000US,,United States,,2013,1121,Fire Protection - Firefighters,0,0,0,0,0,0,0,0
0100000US,,United States,,2013,1122,Fire Protection - Other ,0,0,0,0,0,0,0,0
0100000US,,United States,,2013,1140,Corrections,435236,1852966252,17002,33864277,1291313,442567,452238,1886830529
0100000US,,United States,,2013,1160,Highways,211973,977544202,10847,26093178,1056952,218099,222820,1003637380
0100000US,,United States,,2013,1180,Air Transportation,3170,17228011,67,136911,6180,3205,3237,17364922
0100000US,,United States,,2013,1200,Water Transport and Terminals       ,4563,25181488,141,295060,13261,4639,4704,25476548
0100000US,,United States,,2013,1220,Public Welfare,223577,867992577,12952,32078364,1478418,232021,236529,900070941
0100000US,,United States,,2013,1240,Health,172715,768398162,17724,40708524,1573363,181688,190439,809106686
0100000US,,United States,,2013,1260,Hospitals,352146,1646975261,77872,271142041,8174853,398849,430018,1918117302
0100000US,,United States,,2013,1280,Social Insurance Administration,75959,323214879,7315,16612165,775474,80434,83274,339827044
0100000US,,United States,,2013,1300,Solid Waste Management,2111,12178041,291,921265,35079,2311,2402,13099306
0100000US,,United States,,2013,1320,Sewerage,1643,10033580,47,219043,3698,1665,1690,10252623
0100000US,,United States,,2013,1340,Parks and Recreation,29338,107251348,11062,14836514,1051421,35374,40400,122087862
0100000US,,United States,,2013,1360,Housing and Community Development,473,2461564,64,145389,7750,517,537,2606953
0100000US,,United States,,2013,1380,Natural Resources,118298,531516803,25737,41174114,2288140,131312,144035,572690917
0100000US,,United States,,2013,1400,Water Supply,746,4290455,32,84521,3001,765,778,4374976
0100000US,,United States,,2013,1420,Electric Power,4089,28242282,46,138459,4557,4114,4135,28380741
0100000US,,United States,,2013,1440,Gas Supply,0,0,0,0,0,0,0,0
0100000US,,United States,,2013,1460,Transit,30711,196738639,1375,2662059,134158,31469,32086,199400698
0100000US,,United States,,2013,1480,Education Total ,1395246,7622222071,1353977,1619423872,82159951,1866857,2749223,9241645943
0100000US,,United States,,2013,1481,Education - Elementary and Secondary Total ,43310,212494984,17271,17833499,785119,48135,60581,230328483
0100000US,,United States,,2013,14811,Education - Elementary and Secondary Instructional             ,32333,173554227,12670,12460913,546306,35664,45003,186015140
0100000US,,United States,,2013,14812,Education - Elementary and Secondary Other ,10977,38940757,4601,5372586,238813,12471,15578,44313343
0100000US,,United States,,2013,1482,Education - Higher Education Total ,1272152,7051410748,1323273,1577777907,80313326,1732878,2595425,8629188655
0100000US,,United States,,2013,14821,Education - Higher Education Instructional,407282,3115434376,427015,758842489,27072901,563251,834297,3874276865
0100000US,,United States,,2013,14822,Education - Higher Education Other ,864870,3935976372,896258,818935418,53240425,1169627,1761128,4754911790
0100000US,,United States,,2013,1483,Education - Other,79784,358316339,13433,23812466,1061506,85844,93217,382128805
0100000US,,United States,,2013,1500,Libraries                          ,472,1557888,273,259386,20426,587,745,1817274
0100000US,,United States,,2013,1560,State liquor stores,6003,20147276,5280,7587851,477612,8801,11283,27735127
0100000US,,United States,,2013,1580,All other and unallocable,169892,808278365,14239,27227797,1192919,176698,184131,835506162
0400000US01,01,Alabama,,2013,1000,Total - All Government Employment Functions,78955,342315590,30226,30934398,1798658,89366,109181,373249988
0400000US01,01,Alabama,,2013,1020,Financial Administration,2432,10538974,67,130415,6892,2471,2499,10669389
0400000US01,01,Alabama,,2013,1040,Other Government Administration,512,2593707,218,576428,23395,645,730,3170135
0400000US01,01,Alabama,,2013,1060,Judicial and Legal,3145,13883267,243,419411,30241,3316,3388,14302678
0400000US01,01,Alabama,,2013,1100,Police Protection Total,1389,5234956,0,0,0,1389,1389,5234956
0400000US01,01,Alabama,,2013,1101,Police Protection - Persons with Power of Arrest       ,719,3159110,0,0,0,719,719,3159110
0400000US01,01,Alabama,,2013,1102,Police Protection - Other ,670,2075846,0,0,0,670,670,2075846
0400000US01,01,Alabama,,2013,1120,Fire Protection Total ,0,0,0,0,0,0,0,0
0400000US01,01,Alabama,,2013,1121,Fire Protection - Firefighters,0,0,0,0,0,0,0,0
0400000US01,01,Alabama,,2013,1122,Fire Protection - Other ,0,0,0,0,0,0,0,0
0400000US01,01,Alabama,,2013,1140,Corrections,4874,15867622,99,196056,10276,4932,4973,16063678
0400000US01,01,Alabama,,2013,1160,Highways,4210,15226494,59,45784,4720,4237,4269,15272278
0400000US01,01,Alabama,,2013,1180,Air Transportation,0,0,0,0,0,0,0,0
0400000US01,01,Alabama,,2013,1200,Water Transport and Terminals       ,594,2830271,1,1775,80,594,595,2832046
0400000US01,01,Alabama,,2013,1220,Public Welfare,3907,13547783,93,159750,7974,3952,4000,13707533
0400000US01,01,Alabama,,2013,1240,Health,5149,19010440,349,445302,35862,5352,5498,19455742
0400000US01,01,Alabama,,2013,1260,Hospitals,10913,46925069,1658,3426842,134097,11709,12571,50351911
0400000US01,01,Alabama,,2013,1280,Social Insurance Administration,923,3389544,104,134848,13336,998,1027,3524392
0400000US01,01,Alabama,,2013,1300,Solid Waste Management,0,0,0,0,0,0,0,0
0400000US01,01,Alabama,,2013,1320,Sewerage,0,0,0,0,0,0,0,0
0400000US01,01,Alabama,,2013,1340,Parks and Recreation,355,1027312,276,291978,34396,550,631,1319290
0400000US01,01,Alabama,,2013,1360,Housing and Community Development,0,0,0,0,0,0,0,0
0400000US01,01,Alabama,,2013,1380,Natural Resources,1860,7311999,125,148219,10684,1919,1985,7460218
0400000US01,01,Alabama,,2013,1400,Water Supply,0,0,0,0,0,0,0,0
0400000US01,01,Alabama,,2013,1420,Electric Power,0,0,0,0,0,0,0,0
0400000US01,01,Alabama,,2013,1440,Gas Supply,0,0,0,0,0,0,0,0
0400000US01,01,Alabama,,2013,1460,Transit,0,0,0,0,0,0,0,0
0400000US01,01,Alabama,,2013,1480,Education Total ,36017,174950111,26318,24214903,1422155,44263,62335,199165014
0400000US01,01,Alabama,,2013,1481,Education - Elementary and Secondary Total ,0,0,0,0,0,0,0,0
0400000US01,01,Alabama,,2013,14811,Education - Elementary and Secondary Instructional             ,0,0,0,0,0,0,0,0
0400000US01,01,Alabama,,2013,14812,Education - Elementary and Secondary Other ,0,0,0,0,0,0,0,0
0400000US01,01,Alabama,,2013,1482,Education - Higher Education Total ,33132,163849641,26169,24081876,1416256,41345,59301,187931517
0400000US01,01,Alabama,,2013,14821,Education - Higher Education Instructional,9945,74193023,9238,11701563,485938,12759,19183,85894586
0400000US01,01,Alabama,,2013,14822,Education - Higher Education Other ,23187,89656618,16931,12380313,930318,28586,40118,102036931
0400000US01,01,Alabama,,2013,1483,Education - Other,2885,11100470,149,133027,5899,2918,3034,11233497
0400000US01,01,Alabama,,2013,1500,Libraries                          ,0,0,0,0,0,0,0,0
0400000US01,01,Alabama,,2013,1560,State liquor stores,715,1829852,13,22176,1348,723,728,1852028
0400000US01,01,Alabama,,2013,1580,All other and unallocable,1960,8148189,603,720511,63202,2316,2563,8868700
0400000US02,02,Alaska,,2013,1000,Total - All Government Employment Functions,25015,139767872,5854,7838316,401943,27345,30869,147606188
0400000US02,02,Alaska,,2013,1020,Financial Administration,1105,6593154,39,55520,2180,1120,1144,6648674
0400000US02,02,Alaska,,2013,1040,Other Government Administration,781,4269972,44,77410,3312,800,825,4347382
0400000US02,02,Alaska,,2013,1060,Judicial and Legal,1471,9137934,55,149884,4284,1497,1526,9287818
0400000US02,02,Alaska,,2013,1100,Police Protection Total,658,4305374,33,38012,2228,671,691,4343386
0400000US02,02,Alaska,,2013,1101,Police Protection - Persons with Power of Arrest       ,311,2591166,0,0,0,311,311,2591166
0400000US02,02,Alaska,,2013,1102,Police Protection - Other ,347,1714208,33,38012,2228,360,380,1752220
0400000US02,02,Alaska,,2013,1120,Fire Protection Total ,0,0,0,0,0,0,0,0
0400000US02,02,Alaska,,2013,1121,Fire Protection - Firefighters,0,0,0,0,0,0,0,0
0400000US02,02,Alaska,,2013,1122,Fire Protection - Other ,0,0,0,0,0,0,0,0
0400000US02,02,Alaska,,2013,1140,Corrections,2053,11429035,68,150368,6884,2095,2121,11579403
0400000US02,02,Alaska,,2013,1160,Highways,3153,18231100,52,84548,4882,3182,3205,18315648
0400000US02,02,Alaska,,2013,1180,Air Transportation,0,0,0,0,0,0,0,0
0400000US02,02,Alaska,,2013,1200,Water Transport and Terminals       ,0,0,0,0,0,0,0,0
0400000US02,02,Alaska,,2013,1220,Public Welfare,1811,8724520,119,205122,17856,1918,1930,8929642
0400000US02,02,Alaska,,2013,1240,Health,729,4176046,16,43380,1300,737,745,4219426
0400000US02,02,Alaska,,2013,1260,Hospitals,226,1247590,26,59914,3574,248,252,1307504
0400000US02,02,Alaska,,2013,1280,Social Insurance Administration,384,1844920,7,14860,652,388,391,1859780
0400000US02,02,Alaska,,2013,1300,Solid Waste Management,0,0,0,0,0,0,0,0
0400000US02,02,Alaska,,2013,1320,Sewerage,0,0,0,0,0,0,0,0
0400000US02,02,Alaska,,2013,1340,Parks and Recreation,88,471790,2,4950,220,89,90,476740
0400000US02,02,Alaska,,2013,1360,Housing and Community Development,0,0,0,0,0,0,0,0
0400000US02,02,Alaska,,2013,1380,Natural Resources,2394,13433704,114,229391,9053,2447,2508,13663095
0400000US02,02,Alaska,,2013,1400,Water Supply,0,0,0,0,0,0,0,0
0400000US02,02,Alaska,,2013,1420,Electric Power,0,0,0,0,0,0,0,0
0400000US02,02,Alaska,,2013,1440,Gas Supply,0,0,0,0,0,0,0,0
0400000US02,02,Alaska,,2013,1460,Transit,0,0,0,0,0,0,0,0
0400000US02,02,Alaska,,2013,1480,Education Total ,7335,39104015,5226,6648363,341854,9303,12561,45752378
0400000US02,02,Alaska,,2013,1481,Education - Elementary and Secondary Total ,2627,11402776,1164,1461274,80919,3120,3791,12864050
0400000US02,02,Alaska,,2013,14811,Education - Elementary and Secondary Instructional             ,1996,9105263,571,657817,35008,2209,2567,9763080
0400000US02,02,Alaska,,2013,14812,Education - Elementary and Secondary Other ,631,2297513,593,803457,45911,911,1224,3100970
0400000US02,02,Alaska,,2013,1482,Education - Higher Education Total ,4447,26194063,4035,5152377,259219,5912,8482,31346440
0400000US02,02,Alaska,,2013,14821,Education - Higher Education Instructional,1488,11616271,1136,1397429,57343,1812,2624,13013700
0400000US02,02,Alaska,,2013,14822,Education - Higher Education Other ,2959,14577792,2899,3754948,201876,4100,5858,18332740
0400000US02,02,Alaska,,2013,1483,Education - Other,261,1507176,27,34712,1716,271,288,1541888
0400000US02,02,Alaska,,2013,1500,Libraries                          ,0,0,0,0,0,0,0,0
0400000US02,02,Alaska,,2013,1560,State liquor stores,0,0,0,0,0,0,0,0
0400000US02,02,Alaska,,2013,1580,All other and unallocable,2827,16798718,53,76594,3664,2850,2880,16875312
0400000US04,04,Arizona,,2013,1000,Total - All Government Employment Functions,65397,297991137,29924,33747917,2029107,76865,95321,331739054
0400000US04,04,Arizona,,2013,1020,Financial Administration,2374,9098750,37,100686,3470,2393,2411,9199436
0400000US04,04,Arizona,,2013,1040,Other Government Administration,751,3091137,78,150290,4000,775,829,3241427
0400000US04,04,Arizona,,2013,1060,Judicial and Legal,2010,9300320,72,265310,7547,2054,2082,9565630
0400000US04,04,Arizona,,2013,1100,Police Protection Total,1884,9503589,40,83986,3009,1901,1924,9587575
0400000US04,04,Arizona,,2013,1101,Police Protection - Persons with Power of Arrest       ,1103,6107299,0,0,0,1103,1103,6107299
0400000US04,04,Arizona,,2013,1102,Police Protection - Other ,781,3396290,40,83986,3009,798,821,3480276
0400000US04,04,Arizona,,2013,1120,Fire Protection Total ,0,0,0,0,0,0,0,0
0400000US04,04,Arizona,,2013,1121,Fire Protection - Firefighters,0,0,0,0,0,0,0,0
0400000US04,04,Arizona,,2013,1122,Fire Protection - Other ,0,0,0,0,0,0,0,0
0400000US04,04,Arizona,,2013,1140,Corrections,9751,34486353,18,45937,1257,9758,9769,34532290
0400000US04,04,Arizona,,2013,1160,Highways,2843,12463554,35,87070,3029,2860,2878,12550624
0400000US04,04,Arizona,,2013,1180,Air Transportation,0,0,0,0,0,0,0,0
0400000US04,04,Arizona,,2013,1200,Water Transport and Terminals       ,0,0,0,0,0,0,0,0
0400000US04,04,Arizona,,2013,1220,Public Welfare,5769,20020535,104,190236,10639,5829,5873,20210771
0400000US04,04,Arizona,,2013,1240,Health,2375,9850598,44,117311,4431,2400,2419,9967909
0400000US04,04,Arizona,,2013,1260,Hospitals,6264,29351951,1126,3647787,123513,6962,7390,32999738
0400000US04,04,Arizona,,2013,1280,Social Insurance Administration,2016,6079955,61,104716,6030,2050,2077,6184671
0400000US04,04,Arizona,,2013,1300,Solid Waste Management,0,0,0,0,0,0,0,0
0400000US04,04,Arizona,,2013,1320,Sewerage,0,0,0,0,0,0,0,0
0400000US04,04,Arizona,,2013,1340,Parks and Recreation,329,858436,5,1218,33,329,334,859654
0400000US04,04,Arizona,,2013,1360,Housing and Community Development,0,0,0,0,0,0,0,0
0400000US04,04,Arizona,,2013,1380,Natural Resources,1425,5982210,213,370235,21089,1544,1638,6352445
0400000US04,04,Arizona,,2013,1400,Water Supply,0,0,0,0,0,0,0,0
0400000US04,04,Arizona,,2013,1420,Electric Power,8,60190,0,0,0,8,8,60190
0400000US04,04,Arizona,,2013,1440,Gas Supply,0,0,0,0,0,0,0,0
0400000US04,04,Arizona,,2013,1460,Transit,0,0,0,0,0,0,0,0
0400000US04,04,Arizona,,2013,1480,Education Total ,24481,134731324,27962,28346207,1831465,34828,52443,163077531
0400000US04,04,Arizona,,2013,1481,Education - Elementary and Secondary Total ,0,0,0,0,0,0,0,0
0400000US04,04,Arizona,,2013,14811,Education - Elementary and Secondary Instructional             ,0,0,0,0,0,0,0,0
0400000US04,04,Arizona,,2013,14812,Education - Elementary and Secondary Other ,0,0,0,0,0,0,0,0
0400000US04,04,Arizona,,2013,1482,Education - Higher Education Total ,21409,123493362,27665,27847637,1801713,31588,49074,151340999
0400000US04,04,Arizona,,2013,14821,Education - Higher Education Instructional,6915,51205333,10032,12395707,668701,10693,16947,63601040
0400000US04,04,Arizona,,2013,14822,Education - Higher Education Other ,14494,72288029,17633,15451930,1133012,20895,32127,87739959
0400000US04,04,Arizona,,2013,1483,Education - Other,3072,11237962,297,498570,29752,3240,3369,11736532
0400000US04,04,Arizona,,2013,1500,Libraries                          ,0,0,0,0,0,0,0,0
0400000US04,04,Arizona,,2013,1560,State liquor stores,0,0,0,0,0,0,0,0
0400000US04,04,Arizona,,2013,1580,All other and unallocable,3117,13112235,129,236928,9595,3174,3246,13349163
0400000US05,05,Arkansas,,2013,1000,Total - All Government Employment Functions,58563,226060263,15903,15507970,971411,64056,74466,241568233
0400000US05,05,Arkansas,,2013,1020,Financial Administration,2008,7210328,14,19284,948,2013,2022,7229612
0400000US05,05,Arkansas,,2013,1040,Other Government Administration,763,3283264,136,186737,10003,820,899,3470001
0400000US05,05,Arkansas,,2013,1060,Judicial and Legal,1319,4920862,151,454005,13687,1395,1470,5374867
0400000US05,05,Arkansas,,2013,1100,Police Protection Total,1217,4546935,13,19814,1220,1224,1230,4566749
0400000US05,05,Arkansas,,2013,1101,Police Protection - Persons with Power of Arrest       ,552,2418900,0,0,0,552,552,2418900
0400000US05,05,Arkansas,,2013,1102,Police Protection - Other ,665,2128035,13,19814,1220,672,678,2147849
0400000US05,05,Arkansas,,2013,1120,Fire Protection Total ,0,0,0,0,0,0,0,0
0400000US05,05,Arkansas,,2013,1121,Fire Protection - Firefighters,0,0,0,0,0,0,0,0
0400000US05,05,Arkansas,,2013,1122,Fire Protection - Other ,0,0,0,0,0,0,0,0
0400000US05,05,Arkansas,,2013,1140,Corrections,5521,16941218,14,21863,1873,5532,5535,16963081
0400000US05,05,Arkansas,,2013,1160,Highways,3359,12399615,27,54817,3569,3379,3386,12454432
0400000US05,05,Arkansas,,2013,1180,Air Transportation,0,0,0,0,0,0,0,0
0400000US05,05,Arkansas,,2013,1200,Water Transport and Terminals       ,0,0,0,0,0,0,0,0
0400000US05,05,Arkansas,,2013,1220,Public Welfare,3930,12450988,52,54110,3990,3953,3982,12505098
0400000US05,05,Arkansas,,2013,1240,Health,4240,14131568,130,285886,11357,4305,4370,14417454
0400000US05,05,Arkansas,,2013,1260,Hospitals,6457,23708100,508,973263,60557,6799,6965,24681363
0400000US05,05,Arkansas,,2013,1280,Social Insurance Administration,1468,5190816,1,1738,93,1469,1469,5192554
0400000US05,05,Arkansas,,2013,1300,Solid Waste Management,0,0,0,0,0,0,0,0
0400000US05,05,Arkansas,,2013,1320,Sewerage,0,0,0,0,0,0,0,0
0400000US05,05,Arkansas,,2013,1340,Parks and Recreation,1056,2323872,6,3372,562,1059,1062,2327244
0400000US05,05,Arkansas,,2013,1360,Housing and Community Development,0,0,0,0,0,0,0,0
0400000US05,05,Arkansas,,2013,1380,Natural Resources,1953,6288337,346,279231,22583,2080,2299,6567568
0400000US05,05,Arkansas,,2013,1400,Water Supply,0,0,0,0,0,0,0,0
0400000US05,05,Arkansas,,2013,1420,Electric Power,0,0,0,0,0,0,0,0
0400000US05,05,Arkansas,,2013,1440,Gas Supply,0,0,0,0,0,0,0,0
0400000US05,05,Arkansas,,2013,1460,Transit,0,0,0,0,0,0,0,0
0400000US05,05,Arkansas,,2013,1480,Education Total ,22748,103403251,14406,13042021,832035,27452,37154,116445272
0400000US05,05,Arkansas,,2013,1481,Education - Elementary and Secondary Total ,0,0,0,0,0,0,0,0
0400000US05,05,Arkansas,,2013,14811,Education - Elementary and Secondary Instructional             ,0,0,0,0,0,0,0,0
0400000US05,05,Arkansas,,2013,14812,Education - Elementary and Secondary Other ,0,0,0,0,0,0,0,0
0400000US05,05,Arkansas,,2013,1482,Education - Higher Education Total ,21289,98162622,14385,13012529,830342,25983,35674,111175151
0400000US05,05,Arkansas,,2013,14821,Education - Higher Education Instructional,6700,46483489,5146,6677512,300952,8400,11846,53161001
0400000US05,05,Arkansas,,2013,14822,Education - Higher Education Other ,14589,51679133,9239,6335017,529390,17583,23828,58014150
0400000US05,05,Arkansas,,2013,1483,Education - Other,1459,5240629,21,29492,1693,1469,1480,5270121
0400000US05,05,Arkansas,,2013,1500,Libraries                          ,0,0,0,0,0,0,0,0
0400000US05,05,Arkansas,,2013,1560,State liquor stores,0,0,0,0,0,0,0,0
0400000US05,05,Arkansas,,2013,1580,All other and unallocable,2524,9261109,99,111829,8934,2576,2623,9372938
0400000US06,06,California,,2013,1000,Total - All Government Employment Functions,326705,2081007855,159106,351470365,12502503,397348,485811,2432478220
0400000US06,06,California,,2013,1020,Financial Administration,24000,112569644,2555,4918518,298635,25687,26555,117488162
0400000US06,06,California,,2013,1040,Other Government Administration,3699,20718365,312,872962,29976,3880,4011,21591327
0400000US06,06,California,,2013,1060,Judicial and Legal,6148,40212148,570,1323365,35381,6348,6718,41535513
0400000US06,06,California,,2013,1100,Police Protection Total,10907,80212501,248,182663,6587,10944,11155,80395164
0400000US06,06,California,,2013,1101,Police Protection - Persons with Power of Arrest       ,7560,66818025,191,74335,1784,7570,7751,66892360
0400000US06,06,California,,2013,1102,Police Protection - Other ,3347,13394476,57,108328,4803,3374,3404,13502804
0400000US06,06,California,,2013,1120,Fire Protection Total ,0,0,0,0,0,0,0,0
0400000US06,06,California,,2013,1121,Fire Protection - Firefighters,0,0,0,0,0,0,0,0
0400000US06,06,California,,2013,1122,Fire Protection - Other ,0,0,0,0,0,0,0,0
0400000US06,06,California,,2013,1140,Corrections,50418,355659432,1562,6224608,192577,51506,51980,361884040
0400000US06,06,California,,2013,1160,Highways,19166,137738721,1024,3724189,140072,19957,20190,141462910
0400000US06,06,California,,2013,1180,Air Transportation,0,0,0,0,0,0,0,0
0400000US06,06,California,,2013,1200,Water Transport and Terminals       ,0,0,0,0,0,0,0,0
0400000US06,06,California,,2013,1220,Public Welfare,3596,16447155,294,665725,22705,3724,3890,17112880
0400000US06,06,California,,2013,1240,Health,12650,74764090,1683,4471523,153843,13519,14333,79235613
0400000US06,06,California,,2013,1260,Hospitals,29573,215101518,18218,104232083,2186654,41927,47791,319333601
0400000US06,06,California,,2013,1280,Social Insurance Administration,13966,65921145,1388,3661947,155385,14844,15354,69583092
0400000US06,06,California,,2013,1300,Solid Waste Management,583,3175271,87,169492,9082,634,670,3344763
0400000US06,06,California,,2013,1320,Sewerage,0,0,0,0,0,0,0,0
0400000US06,06,California,,2013,1340,Parks and Recreation,2176,10706468,2013,3053300,207137,3346,4189,13759768
0400000US06,06,California,,2013,1360,Housing and Community Development,0,0,0,0,0,0,0,0
0400000US06,06,California,,2013,1380,Natural Resources,12843,76948707,2773,4578370,336449,14743,15616,81527077
0400000US06,06,California,,2013,1400,Water Supply,0,0,0,0,0,0,0,0
0400000US06,06,California,,2013,1420,Electric Power,0,0,0,0,0,0,0,0
0400000US06,06,California,,2013,1440,Gas Supply,0,0,0,0,0,0,0,0
0400000US06,06,California,,2013,1460,Transit,0,0,0,0,0,0,0,0
0400000US06,06,California,,2013,1480,Education Total ,117211,759971590,124534,208567072,8583633,165707,241745,968538662
0400000US06,06,California,,2013,1481,Education - Elementary and Secondary Total ,0,0,0,0,0,0,0,0
0400000US06,06,California,,2013,14811,Education - Elementary and Secondary Instructional             ,0,0,0,0,0,0,0,0
0400000US06,06,California,,2013,14812,Education - Elementary and Secondary Other ,0,0,0,0,0,0,0,0
0400000US06,06,California,,2013,1482,Education - Higher Education Total ,113260,740799551,124072,207676515,8542321,161522,237332,948476066
0400000US06,06,California,,2013,14821,Education - Higher Education Instructional,24643,219576311,30862,60477098,2036576,36149,55505,280053409
0400000US06,06,California,,2013,14822,Education - Higher Education Other ,88617,521223240,93210,147199417,6505745,125373,181827,668422657
0400000US06,06,California,,2013,1483,Education - Other,3951,19172039,462,890557,41312,4185,4413,20062596
0400000US06,06,California,,2013,1500,Libraries                          ,0,0,0,0,0,0,0,0
0400000US06,06,California,,2013,1560,State liquor stores,0,0,0,0,0,0,0,0
0400000US06,06,California,,2013,1580,All other and unallocable,19769,110861100,1845,4824548,144387,20582,21614,115685648
0400000US08,08,Colorado,,2013,1000,Total - All Government Employment Functions,55867,292062842,46673,82928053,3600157,77637,102540,374990895
0400000US08,08,Colorado,,2013,1020,Financial Administration,1751,8728865,60,153798,5351,1781,1811,8882663
0400000US08,08,Colorado,,2013,1040,Other Government Administration,444,1862244,168,451254,25412,587,612,2313498
0400000US08,08,Colorado,,2013,1060,Judicial and Legal,4275,21304310,564,1570822,59850,4613,4839,22875132
0400000US08,08,Colorado,,2013,1100,Police Protection Total,1218,6695092,17,39004,1390,1226,1235,6734096
0400000US08,08,Colorado,,2013,1101,Police Protection - Persons with Power of Arrest       ,754,4558580,0,0,0,754,754,4558580
0400000US08,08,Colorado,,2013,1102,Police Protection - Other ,464,2136512,17,39004,1390,472,481,2175516
0400000US08,08,Colorado,,2013,1120,Fire Protection Total ,0,0,0,0,0,0,0,0
0400000US08,08,Colorado,,2013,1121,Fire Protection - Firefighters,0,0,0,0,0,0,0,0
0400000US08,08,Colorado,,2013,1122,Fire Protection - Other ,0,0,0,0,0,0,0,0
0400000US08,08,Colorado,,2013,1140,Corrections,6993,28917081,57,211478,7460,7035,7050,29128559
0400000US08,08,Colorado,,2013,1160,Highways,2963,13745925,145,372348,21787,3086,3108,14118273
0400000US08,08,Colorado,,2013,1180,Air Transportation,0,0,0,0,0,0,0,0
0400000US08,08,Colorado,,2013,1200,Water Transport and Terminals       ,0,0,0,0,0,0,0,0
0400000US08,08,Colorado,,2013,1220,Public Welfare,2008,8717997,334,834831,36952,2217,2342,9552828
0400000US08,08,Colorado,,2013,1240,Health,1190,6577540,158,503637,17433,1288,1348,7081177
0400000US08,08,Colorado,,2013,1260,Hospitals,4701,18903876,1019,4792247,141683,5583,5720,23696123
0400000US08,08,Colorado,,2013,1280,Social Insurance Administration,869,4073815,279,762996,44646,1121,1148,4836811
0400000US08,08,Colorado,,2013,1300,Solid Waste Management,0,0,0,0,0,0,0,0
0400000US08,08,Colorado,,2013,1320,Sewerage,0,0,0,0,0,0,0,0
0400000US08,08,Colorado,,2013,1340,Parks and Recreation,879,4249368,243,375458,21969,1003,1122,4624826
0400000US08,08,Colorado,,2013,1360,Housing and Community Development,0,0,0,0,0,0,0,0
0400000US08,08,Colorado,,2013,1380,Natural Resources,951,5013387,177,323376,17999,1053,1128,5336763
0400000US08,08,Colorado,,2013,1400,Water Supply,0,0,0,0,0,0,0,0
0400000US08,08,Colorado,,2013,1420,Electric Power,0,0,0,0,0,0,0,0
0400000US08,08,Colorado,,2013,1440,Gas Supply,0,0,0,0,0,0,0,0
0400000US08,08,Colorado,,2013,1460,Transit,0,0,0,0,0,0,0,0
0400000US08,08,Colorado,,2013,1480,Education Total ,25315,151067336,43389,72360006,3189170,44683,68704,223427342
0400000US08,08,Colorado,,2013,1481,Education - Elementary and Secondary Total ,0,0,0,0,0,0,0,0
0400000US08,08,Colorado,,2013,14811,Education - Elementary and Secondary Instructional             ,0,0,0,0,0,0,0,0
0400000US08,08,Colorado,,2013,14812,Education - Elementary and Secondary Other ,0,0,0,0,0,0,0,0
0400000US08,08,Colorado,,2013,1482,Education - Higher Education Total ,24278,145790360,42229,70759775,3098970,43136,66507,216550135
0400000US08,08,Colorado,,2013,14821,Education - Higher Education Instructional,9142,75047049,15461,39347138,1436136,18074,24603,114394187
0400000US08,08,Colorado,,2013,14822,Education - Higher Education Other ,15136,70743311,26768,31412637,1662834,25062,41904,102155948
0400000US08,08,Colorado,,2013,1483,Education - Other,1037,5276976,1160,1600231,90200,1547,2197,6877207
0400000US08,08,Colorado,,2013,1500,Libraries                          ,0,0,0,0,0,0,0,0
0400000US08,08,Colorado,,2013,1560,State liquor stores,0,0,0,0,0,0,0,0
0400000US08,08,Colorado,,2013,1580,All other and unallocable,2310,12206006,63,176798,9055,2361,2373,12382804
0400000US09,09,Connecticut,,2013,1000,Total - All Government Employment Functions,53612,334772251,25069,40657531,1539753,62634,78681,375429782
0400000US09,09,Connecticut,,2013,1020,Financial Administration,2231,13100057,115,323521,12263,2301,2346,13423578
0400000US09,09,Connecticut,,2013,1040,Other Government Administration,1324,7888531,246,868216,27969,1482,1570,8756747
0400000US09,09,Connecticut,,2013,1060,Judicial and Legal,5956,35064375,320,821673,13271,6031,6276,35886048
0400000US09,09,Connecticut,,2013,1100,Police Protection Total,1925,13671235,240,157318,5713,1957,2165,13828553
0400000US09,09,Connecticut,,2013,1101,Police Protection - Persons with Power of Arrest       ,1274,9974503,2,2708,135,1275,1276,9977211
0400000US09,09,Connecticut,,2013,1102,Police Protection - Other ,651,3696732,238,154610,5578,682,889,3851342
0400000US09,09,Connecticut,,2013,1120,Fire Protection Total ,0,0,0,0,0,0,0,0
0400000US09,09,Connecticut,,2013,1121,Fire Protection - Firefighters,0,0,0,0,0,0,0,0
0400000US09,09,Connecticut,,2013,1122,Fire Protection - Other ,0,0,0,0,0,0,0,0
0400000US09,09,Connecticut,,2013,1140,Corrections,5642,34263350,72,243853,5881,5675,5714,34507203
0400000US09,09,Connecticut,,2013,1160,Highways,3170,19889084,5,22894,729,3174,3175,19911978
0400000US09,09,Connecticut,,2013,1180,Air Transportation,148,1091464,0,0,0,148,148,1091464
0400000US09,09,Connecticut,,2013,1200,Water Transport and Terminals       ,0,0,0,0,0,0,0,0
0400000US09,09,Connecticut,,2013,1220,Public Welfare,5239,31574045,445,1680010,60756,5583,5684,33254055
0400000US09,09,Connecticut,,2013,1240,Health,3765,21596383,565,1802021,48554,4040,4330,23398404
0400000US09,09,Connecticut,,2013,1260,Hospitals,5232,33124202,1814,7417815,227688,6518,7046,40542017
0400000US09,09,Connecticut,,2013,1280,Social Insurance Administration,759,3987138,1,1647,64,759,760,3988785
0400000US09,09,Connecticut,,2013,1300,Solid Waste Management,43,279348,3,8235,359,45,46,287583
0400000US09,09,Connecticut,,2013,1320,Sewerage,0,0,0,0,0,0,0,0
0400000US09,09,Connecticut,,2013,1340,Parks and Recreation,149,836021,16,28974,1282,156,165,864995
0400000US09,09,Connecticut,,2013,1360,Housing and Community Development,1,9161,0,0,0,1,1,9161
0400000US09,09,Connecticut,,2013,1380,Natural Resources,668,3963734,100,188379,6969,708,768,4152113
0400000US09,09,Connecticut,,2013,1400,Water Supply,0,0,0,0,0,0,0,0
0400000US09,09,Connecticut,,2013,1420,Electric Power,0,0,0,0,0,0,0,0
0400000US09,09,Connecticut,,2013,1440,Gas Supply,0,0,0,0,0,0,0,0
0400000US09,09,Connecticut,,2013,1460,Transit,0,0,0,0,0,0,0,0
0400000US09,09,Connecticut,,2013,1480,Education Total ,14861,98841914,20784,26522405,1103398,21416,35645,125364319
0400000US09,09,Connecticut,,2013,1481,Education - Elementary and Secondary Total ,0,0,0,0,0,0,0,0
0400000US09,09,Connecticut,,2013,14811,Education - Elementary and Secondary Instructional             ,0,0,0,0,0,0,0,0
0400000US09,09,Connecticut,,2013,14812,Education - Elementary and Secondary Other ,0,0,0,0,0,0,0,0
0400000US09,09,Connecticut,,2013,1482,Education - Higher Education Total ,12174,83456419,19776,24164913,1018826,18251,31950,107621332
0400000US09,09,Connecticut,,2013,14821,Education - Higher Education Instructional,4583,38008894,7854,14323382,435588,7218,12437,52332276
0400000US09,09,Connecticut,,2013,14822,Education - Higher Education Other ,7591,45447525,11922,9841531,583238,11033,19513,55289056
0400000US09,09,Connecticut,,2013,1483,Education - Other,2687,15385495,1008,2357492,84572,3165,3695,17742987
0400000US09,09,Connecticut,,2013,1500,Libraries                          ,0,0,0,0,0,0,0,0
0400000US09,09,Connecticut,,2013,1560,State liquor stores,0,0,0,0,0,0,0,0
0400000US09,09,Connecticut,,2013,1580,All other and unallocable,2499,15592209,343,570570,24857,2640,2842,16162779
0400000US10,10,Delaware,,2013,1000,Total - All Government Employment Functions,23413,102682076,8528,11774931,544052,26691,31941,114457007
0400000US10,10,Delaware,,2013,1020,Financial Administration,789,2604629,17,22382,1347,798,806,2627011
0400000US10,10,Delaware,,2013,1040,Other Government Administration,399,1699278,90,139644,5615,432,489,1838922
0400000US10,10,Delaware,,2013,1060,Judicial and Legal,1726,8097209,54,103852,5657,1760,1780,8201061
0400000US10,10,Delaware,,2013,1100,Police Protection Total,1049,6789556,16,28066,1495,1058,1065,6817622
0400000US10,10,Delaware,,2013,1101,Police Protection - Persons with Power of Arrest       ,789,5502396,0,0,0,789,789,5502396
0400000US10,10,Delaware,,2013,1102,Police Protection - Other ,260,1287160,16,28066,1495,269,276,1315226
0400000US10,10,Delaware,,2013,1120,Fire Protection Total ,0,0,0,0,0,0,0,0
0400000US10,10,Delaware,,2013,1121,Fire Protection - Firefighters,0,0,0,0,0,0,0,0
0400000US10,10,Delaware,,2013,1122,Fire Protection - Other ,0,0,0,0,0,0,0,0
0400000US10,10,Delaware,,2013,1140,Corrections,2872,11525163,44,63647,4229,2898,2916,11588810
0400000US10,10,Delaware,,2013,1160,Highways,1528,5052615,0,0,0,1528,1528,5052615
0400000US10,10,Delaware,,2013,1180,Air Transportation,0,0,0,0,0,0,0,0
0400000US10,10,Delaware,,2013,1200,Water Transport and Terminals       ,273,1114738,0,0,0,273,273,1114738
0400000US10,10,Delaware,,2013,1220,Public Welfare,1575,5407682,78,142550,8160,1624,1653,5550232
0400000US10,10,Delaware,,2013,1240,Health,2027,7651663,158,298879,16027,2124,2185,7950542
0400000US10,10,Delaware,,2013,1260,Hospitals,1417,4784782,92,117848,8258,1466,1509,4902630
0400000US10,10,Delaware,,2013,1280,Social Insurance Administration,329,1087259,22,36977,1641,338,351,1124236
0400000US10,10,Delaware,,2013,1300,Solid Waste Management,118,476249,20,32205,2502,133,138,508454
0400000US10,10,Delaware,,2013,1320,Sewerage,0,0,0,0,0,0,0,0
0400000US10,10,Delaware,,2013,1340,Parks and Recreation,301,783979,27,20219,1473,310,328,804198
0400000US10,10,Delaware,,2013,1360,Housing and Community Development,0,0,0,0,0,0,0,0
0400000US10,10,Delaware,,2013,1380,Natural Resources,477,1849423,107,136123,8434,529,584,1985546
0400000US10,10,Delaware,,2013,1400,Water Supply,0,0,0,0,0,0,0,0
0400000US10,10,Delaware,,2013,1420,Electric Power,0,0,0,0,0,0,0,0
0400000US10,10,Delaware,,2013,1440,Gas Supply,0,0,0,0,0,0,0,0
0400000US10,10,Delaware,,2013,1460,Transit,869,3585624,4,14530,551,872,873,3600154
0400000US10,10,Delaware,,2013,1480,Education Total ,5970,33209293,7585,10410253,466614,8781,13555,43619546
0400000US10,10,Delaware,,2013,1481,Education - Elementary and Secondary Total ,0,0,0,0,0,0,0,0
0400000US10,10,Delaware,,2013,14811,Education - Elementary and Secondary Instructional             ,0,0,0,0,0,0,0,0
0400000US10,10,Delaware,,2013,14812,Education - Elementary and Secondary Other ,0,0,0,0,0,0,0,0
0400000US10,10,Delaware,,2013,1482,Education - Higher Education Total ,5628,31180735,7561,10378928,464834,8428,13189,41559663
0400000US10,10,Delaware,,2013,14821,Education - Higher Education Instructional,1530,12301884,3442,6217603,201256,2742,4972,18519487
0400000US10,10,Delaware,,2013,14822,Education - Higher Education Other ,4098,18878851,4119,4161325,263578,5686,8217,23040176
0400000US10,10,Delaware,,2013,1483,Education - Other,342,2028558,24,31325,1780,353,366,2059883
0400000US10,10,Delaware,,2013,1500,Libraries                          ,0,0,0,0,0,0,0,0
0400000US10,10,Delaware,,2013,1560,State liquor stores,0,0,0,0,0,0,0,0
0400000US10,10,Delaware,,2013,1580,All other and unallocable,1694,6962934,214,207756,12049,1767,1908,7170690
0400000US12,12,Florida,,2013,1000,Total - All Government Employment Functions,161839,662203012,46450,57541411,3123146,179485,208289,719744423
0400000US12,12,Florida,,2013,1020,Financial Administration,6331,21659439,152,191414,16149,6422,6483,21850853
0400000US12,12,Florida,,2013,1040,Other Government Administration,1983,8484742,220,240953,17976,2084,2203,8725695
0400000US12,12,Florida,,2013,1060,Judicial and Legal,18982,76106937,754,1213367,64796,19350,19736,77320304
0400000US12,12,Florida,,2013,1100,Police Protection Total,4031,15342744,412,407063,17285,4128,4443,15749807
0400000US12,12,Florida,,2013,1101,Police Protection - Persons with Power of Arrest       ,2165,8942237,237,253757,6866,2204,2402,9195994
0400000US12,12,Florida,,2013,1102,Police Protection - Other ,1866,6400507,175,153306,10419,1924,2041,6553813
0400000US12,12,Florida,,2013,1120,Fire Protection Total ,0,0,0,0,0,0,0,0
0400000US12,12,Florida,,2013,1121,Fire Protection - Firefighters,0,0,0,0,0,0,0,0
0400000US12,12,Florida,,2013,1122,Fire Protection - Other ,0,0,0,0,0,0,0,0
0400000US12,12,Florida,,2013,1140,Corrections,24474,77058943,253,312592,13743,24551,24727,77371535
0400000US12,12,Florida,,2013,1160,Highways,6349,26499176,28,31580,2387,6362,6377,26530756
0400000US12,12,Florida,,2013,1180,Air Transportation,0,0,0,0,0,0,0,0
0400000US12,12,Florida,,2013,1200,Water Transport and Terminals       ,0,0,0,0,0,0,0,0
0400000US12,12,Florida,,2013,1220,Public Welfare,8919,26991797,230,251540,17028,9015,9149,27243337
0400000US12,12,Florida,,2013,1240,Health,18414,59081530,1124,2427254,122295,19105,19538,61508784
0400000US12,12,Florida,,2013,1260,Hospitals,4029,13158594,44,89402,3468,4049,4073,13247996
0400000US12,12,Florida,,2013,1280,Social Insurance Administration,2558,8590246,4,7349,366,2560,2562,8597595
0400000US12,12,Florida,,2013,1300,Solid Waste Management,0,0,0,0,0,0,0,0
0400000US12,12,Florida,,2013,1320,Sewerage,0,0,0,0,0,0,0,0
0400000US12,12,Florida,,2013,1340,Parks and Recreation,1271,3093289,258,272054,17003,1367,1529,3365343
0400000US12,12,Florida,,2013,1360,Housing and Community Development,0,0,0,0,0,0,0,0
0400000US12,12,Florida,,2013,1380,Natural Resources,7735,26031121,755,833335,64727,8101,8490,26864456
0400000US12,12,Florida,,2013,1400,Water Supply,0,0,0,0,0,0,0,0
0400000US12,12,Florida,,2013,1420,Electric Power,0,0,0,0,0,0,0,0
0400000US12,12,Florida,,2013,1440,Gas Supply,0,0,0,0,0,0,0,0
0400000US12,12,Florida,,2013,1460,Transit,682,3093682,71,118677,8791,732,753,3212359
0400000US12,12,Florida,,2013,1480,Education Total ,49719,275537856,41693,50639670,2724217,65111,91412,326177526
0400000US12,12,Florida,,2013,1481,Education - Elementary and Secondary Total ,0,0,0,0,0,0,0,0
0400000US12,12,Florida,,2013,14811,Education - Elementary and Secondary Instructional             ,0,0,0,0,0,0,0,0
0400000US12,12,Florida,,2013,14812,Education - Elementary and Secondary Other ,0,0,0,0,0,0,0,0
0400000US12,12,Florida,,2013,1482,Education - Higher Education Total ,46819,265528636,41399,50402140,2711619,62140,88218,315930776
0400000US12,12,Florida,,2013,14821,Education - Higher Education Instructional,13719,131921886,14557,27209829,1080586,19825,28276,159131715
0400000US12,12,Florida,,2013,14822,Education - Higher Education Other ,33100,133606750,26842,23192311,1631033,42315,59942,156799061
0400000US12,12,Florida,,2013,1483,Education - Other,2900,10009220,294,237530,12598,2971,3194,10246750
0400000US12,12,Florida,,2013,1500,Libraries                          ,0,0,0,0,0,0,0,0
0400000US12,12,Florida,,2013,1560,State liquor stores,0,0,0,0,0,0,0,0
0400000US12,12,Florida,,2013,1580,All other and unallocable,6362,21472916,452,505161,32915,6548,6814,21978077
0400000US13,13,Georgia,,2013,1000,Total - All Government Employment Functions,114241,432577873,55060,52449041,2886658,130557,169301,485026914
0400000US13,13,Georgia,,2013,1020,Financial Administration,3352,11204687,126,175629,9071,3403,3478,11380316
0400000US13,13,Georgia,,2013,1040,Other Government Administration,1189,3721490,101,109843,6064,1223,1290,3831333
0400000US13,13,Georgia,,2013,1060,Judicial and Legal,3940,14291802,63,75857,3936,3961,4003,14367659
0400000US13,13,Georgia,,2013,1100,Police Protection Total,2997,9601088,58,87250,6246,3032,3055,9688338
0400000US13,13,Georgia,,2013,1101,Police Protection - Persons with Power of Arrest       ,1760,5611516,3,4212,208,1761,1763,5615728
0400000US13,13,Georgia,,2013,1102,Police Protection - Other ,1237,3989572,55,83038,6038,1271,1292,4072610
0400000US13,13,Georgia,,2013,1120,Fire Protection Total ,0,0,0,0,0,0,0,0
0400000US13,13,Georgia,,2013,1121,Fire Protection - Firefighters,0,0,0,0,0,0,0,0
0400000US13,13,Georgia,,2013,1122,Fire Protection - Other ,0,0,0,0,0,0,0,0
0400000US13,13,Georgia,,2013,1140,Corrections,18024,37561893,7399,6292110,231311,19331,25423,43854003
0400000US13,13,Georgia,,2013,1160,Highways,4809,13219907,37,12845,686,4813,4846,13232752
0400000US13,13,Georgia,,2013,1180,Air Transportation,2,8426,0,0,0,2,2,8426
0400000US13,13,Georgia,,2013,1200,Water Transport and Terminals       ,993,6576648,0,0,0,993,993,6576648
0400000US13,13,Georgia,,2013,1220,Public Welfare,6721,21015431,121,76517,2502,6736,6842,21091948
0400000US13,13,Georgia,,2013,1240,Health,3815,15314485,110,168031,7295,3856,3925,15482516
0400000US13,13,Georgia,,2013,1260,Hospitals,7742,25189797,305,588101,24565,7880,8047,25777898
0400000US13,13,Georgia,,2013,1280,Social Insurance Administration,1859,4750491,59,48699,3866,1881,1918,4799190
0400000US13,13,Georgia,,2013,1300,Solid Waste Management,0,0,0,0,0,0,0,0
0400000US13,13,Georgia,,2013,1320,Sewerage,0,0,0,0,0,0,0,0
0400000US13,13,Georgia,,2013,1340,Parks and Recreation,2198,7143436,1080,1425102,162738,3118,3278,8568538
0400000US13,13,Georgia,,2013,1360,Housing and Community Development,0,0,0,0,0,0,0,0
0400000US13,13,Georgia,,2013,1380,Natural Resources,4347,14826633,1099,1314496,92316,4870,5446,16141129
0400000US13,13,Georgia,,2013,1400,Water Supply,0,0,0,0,0,0,0,0
0400000US13,13,Georgia,,2013,1420,Electric Power,0,0,0,0,0,0,0,0
0400000US13,13,Georgia,,2013,1440,Gas Supply,0,0,0,0,0,0,0,0
0400000US13,13,Georgia,,2013,1460,Transit,0,0,0,0,0,0,0,0
0400000US13,13,Georgia,,2013,1480,Education Total ,49549,239015356,44280,41933267,2325361,62695,93829,280948623
0400000US13,13,Georgia,,2013,1481,Education - Elementary and Secondary Total ,0,0,0,0,0,0,0,0
0400000US13,13,Georgia,,2013,14811,Education - Elementary and Secondary Instructional             ,0,0,0,0,0,0,0,0
0400000US13,13,Georgia,,2013,14812,Education - Elementary and Secondary Other ,0,0,0,0,0,0,0,0
0400000US13,13,Georgia,,2013,1482,Education - Higher Education Total ,47060,227855930,44084,41635486,2309482,60117,91144,269491416
0400000US13,13,Georgia,,2013,14821,Education - Higher Education Instructional,14154,90465110,16972,23188226,955335,19555,31126,113653336
0400000US13,13,Georgia,,2013,14822,Education - Higher Education Other ,32906,137390820,27112,18447260,1354147,40562,60018,155838080
0400000US13,13,Georgia,,2013,1483,Education - Other,2489,11159426,196,297781,15879,2578,2685,11457207
0400000US13,13,Georgia,,2013,1500,Libraries                          ,0,0,0,0,0,0,0,0
0400000US13,13,Georgia,,2013,1560,State liquor stores,0,0,0,0,0,0,0,0
0400000US13,13,Georgia,,2013,1580,All other and unallocable,2704,9136303,222,141294,10701,2763,2926,9277597
0400000US15,15,Hawaii,,2013,1000,Total - All Government Employment Functions,51757,221743708,20425,18203941,859883,56810,72182,239947649
0400000US15,15,Hawaii,,2013,1020,Financial Administration,646,2423822,2,4682,198,647,648,2428504
0400000US15,15,Hawaii,,2013,1040,Other Government Administration,665,2931922,141,306897,12354,734,806,3238819
0400000US15,15,Hawaii,,2013,1060,Judicial and Legal,2447,10570134,42,92580,2704,2461,2489,10662714
0400000US15,15,Hawaii,,2013,1100,Police Protection Total,0,0,0,0,0,0,0,0
0400000US15,15,Hawaii,,2013,1101,Police Protection - Persons with Power of Arrest       ,0,0,0,0,0,0,0,0
0400000US15,15,Hawaii,,2013,1102,Police Protection - Other ,0,0,0,0,0,0,0,0
0400000US15,15,Hawaii,,2013,1120,Fire Protection Total ,0,0,0,0,0,0,0,0
0400000US15,15,Hawaii,,2013,1121,Fire Protection - Firefighters,0,0,0,0,0,0,0,0
0400000US15,15,Hawaii,,2013,1122,Fire Protection - Other ,0,0,0,0,0,0,0,0
0400000US15,15,Hawaii,,2013,1140,Corrections,2333,9806790,11,57504,834,2337,2344,9864294
0400000US15,15,Hawaii,,2013,1160,Highways,872,3929744,21,9666,948,877,893,3939410
0400000US15,15,Hawaii,,2013,1180,Air Transportation,1014,4096964,11,14172,836,1019,1025,4111136
0400000US15,15,Hawaii,,2013,1200,Water Transport and Terminals       ,210,841668,0,0,0,210,210,841668
0400000US15,15,Hawaii,,2013,1220,Public Welfare,415,1595762,17,12594,1292,422,432,1608356
0400000US15,15,Hawaii,,2013,1240,Health,1958,8705932,47,124702,4008,1981,2005,8830634
0400000US15,15,Hawaii,,2013,1260,Hospitals,4308,22610922,768,2031506,57871,4637,5076,24642428
0400000US15,15,Hawaii,,2013,1280,Social Insurance Administration,276,1059506,24,41070,1916,287,300,1100576
0400000US15,15,Hawaii,,2013,1300,Solid Waste Management,0,0,0,0,0,0,0,0
0400000US15,15,Hawaii,,2013,1320,Sewerage,0,0,0,0,0,0,0,0
0400000US15,15,Hawaii,,2013,1340,Parks and Recreation,137,483642,511,100908,6436,173,648,584550
0400000US15,15,Hawaii,,2013,1360,Housing and Community Development,0,0,0,0,0,0,0,0
0400000US15,15,Hawaii,,2013,1380,Natural Resources,795,3271616,6,9598,536,798,801,3281214
0400000US15,15,Hawaii,,2013,1400,Water Supply,0,0,0,0,0,0,0,0
0400000US15,15,Hawaii,,2013,1420,Electric Power,0,0,0,0,0,0,0,0
0400000US15,15,Hawaii,,2013,1440,Gas Supply,0,0,0,0,0,0,0,0
0400000US15,15,Hawaii,,2013,1460,Transit,0,0,0,0,0,0,0,0
0400000US15,15,Hawaii,,2013,1480,Education Total ,31587,133066222,18511,15081038,746150,35999,50098,148147260
0400000US15,15,Hawaii,,2013,1481,Education - Elementary and Secondary Total ,22003,86036282,12718,10785692,525052,25166,34721,96821974
0400000US15,15,Hawaii,,2013,14811,Education - Elementary and Secondary Instructional             ,16935,71400894,11116,9764558,452174,19659,28051,81165452
0400000US15,15,Hawaii,,2013,14812,Education - Elementary and Secondary Other ,5068,14635388,1602,1021134,72878,5507,6670,15656522
0400000US15,15,Hawaii,,2013,1482,Education - Higher Education Total ,9465,46569062,5790,4289534,220858,10713,15255,50858596
0400000US15,15,Hawaii,,2013,14821,Education - Higher Education Instructional,3994,26301284,788,1028598,34006,4186,4782,27329882
0400000US15,15,Hawaii,,2013,14822,Education - Higher Education Other ,5471,20267778,5002,3260936,186852,6527,10473,23528714
0400000US15,15,Hawaii,,2013,1483,Education - Other,119,460878,3,5812,240,120,122,466690
0400000US15,15,Hawaii,,2013,1500,Libraries                          ,438,1436488,273,259386,20426,553,711,1695874
0400000US15,15,Hawaii,,2013,1560,State liquor stores,0,0,0,0,0,0,0,0
0400000US15,15,Hawaii,,2013,1580,All other and unallocable,3656,14912574,40,57638,3374,3675,3696,14970212
0400000US16,16,Idaho,,2013,1000,Total - All Government Employment Functions,19568,87800447,9620,10250558,601586,22970,29188,98051005
0400000US16,16,Idaho,,2013,1020,Financial Administration,1216,5539229,131,220658,16577,1309,1347,5759887
0400000US16,16,Idaho,,2013,1040,Other Government Administration,241,1031334,84,185052,13764,318,325,1216386
0400000US16,16,Idaho,,2013,1060,Judicial and Legal,469,3814597,56,151577,3005,487,525,3966174
0400000US16,16,Idaho,,2013,1100,Police Protection Total,472,2184809,17,25500,1450,480,489,2210309
0400000US16,16,Idaho,,2013,1101,Police Protection - Persons with Power of Arrest       ,271,1414984,0,0,0,271,271,1414984
0400000US16,16,Idaho,,2013,1102,Police Protection - Other ,201,769825,17,25500,1450,209,218,795325
0400000US16,16,Idaho,,2013,1120,Fire Protection Total ,0,0,0,0,0,0,0,0
0400000US16,16,Idaho,,2013,1121,Fire Protection - Firefighters,0,0,0,0,0,0,0,0
0400000US16,16,Idaho,,2013,1122,Fire Protection - Other ,0,0,0,0,0,0,0,0
0400000US16,16,Idaho,,2013,1140,Corrections,1968,7849408,26,61491,3338,1987,1994,7910899
0400000US16,16,Idaho,,2013,1160,Highways,1450,5479832,65,118008,10934,1512,1515,5597840
0400000US16,16,Idaho,,2013,1180,Air Transportation,0,0,0,0,0,0,0,0
0400000US16,16,Idaho,,2013,1200,Water Transport and Terminals       ,0,0,0,0,0,0,0,0
0400000US16,16,Idaho,,2013,1220,Public Welfare,1686,6175714,104,214005,12843,1759,1790,6389719
0400000US16,16,Idaho,,2013,1240,Health,1579,6998994,312,707449,29132,1744,1891,7706443
0400000US16,16,Idaho,,2013,1260,Hospitals,548,1903037,111,166937,11897,615,659,2069974
0400000US16,16,Idaho,,2013,1280,Social Insurance Administration,552,2636351,171,474760,22996,682,723,3111111
0400000US16,16,Idaho,,2013,1300,Solid Waste Management,0,0,0,0,0,0,0,0
0400000US16,16,Idaho,,2013,1320,Sewerage,0,0,0,0,0,0,0,0
0400000US16,16,Idaho,,2013,1340,Parks and Recreation,149,615990,74,71400,5671,181,223,687390
0400000US16,16,Idaho,,2013,1360,Housing and Community Development,0,0,0,0,0,0,0,0
0400000US16,16,Idaho,,2013,1380,Natural Resources,1494,6988482,630,852155,57444,1819,2124,7840637
0400000US16,16,Idaho,,2013,1400,Water Supply,0,0,0,0,0,0,0,0
0400000US16,16,Idaho,,2013,1420,Electric Power,0,0,0,0,0,0,0,0
0400000US16,16,Idaho,,2013,1440,Gas Supply,0,0,0,0,0,0,0,0
0400000US16,16,Idaho,,2013,1460,Transit,0,0,0,0,0,0,0,0
0400000US16,16,Idaho,,2013,1480,Education Total ,6611,31088721,7578,6666892,390300,8818,14189,37755613
0400000US16,16,Idaho,,2013,1481,Education - Elementary and Secondary Total ,0,0,0,0,0,0,0,0
0400000US16,16,Idaho,,2013,14811,Education - Elementary and Secondary Instructional             ,0,0,0,0,0,0,0,0
0400000US16,16,Idaho,,2013,14812,Education - Elementary and Secondary Other ,0,0,0,0,0,0,0,0
0400000US16,16,Idaho,,2013,1482,Education - Higher Education Total ,6257,29278097,7560,6632100,388470,8453,13817,35910197
0400000US16,16,Idaho,,2013,14821,Education - Higher Education Instructional,2156,12536361,2246,3215288,119628,2832,4402,15751649
0400000US16,16,Idaho,,2013,14822,Education - Higher Education Other ,4101,16741736,5314,3416812,268842,5621,9415,20158548
0400000US16,16,Idaho,,2013,1483,Education - Other,354,1810624,18,34792,1830,365,372,1845416
0400000US16,16,Idaho,,2013,1500,Libraries                          ,0,0,0,0,0,0,0,0
0400000US16,16,Idaho,,2013,1560,State liquor stores,170,571804,171,139336,12743,242,341,711140
0400000US16,16,Idaho,,2013,1580,All other and unallocable,963,4922145,90,195338,9492,1017,1053,5117483
0400000US17,17,Illinois,,2013,1000,Total - All Government Employment Functions,101136,571788883,52754,89638837,4534148,127253,153890,661427720
0400000US17,17,Illinois,,2013,1020,Financial Administration,4638,26407429,307,624879,31217,4826,4945,27032308
0400000US17,17,Illinois,,2013,1040,Other Government Administration,2035,13172138,39,82290,3074,2054,2074,13254428
0400000US17,17,Illinois,,2013,1060,Judicial and Legal,2567,22525759,63,215612,5170,2597,2630,22741371
0400000US17,17,Illinois,,2013,1100,Police Protection Total,3186,22791066,18,59364,1356,3194,3204,22850430
0400000US17,17,Illinois,,2013,1101,Police Protection - Persons with Power of Arrest       ,1957,15103814,0,0,0,1957,1957,15103814
0400000US17,17,Illinois,,2013,1102,Police Protection - Other ,1229,7687252,18,59364,1356,1237,1247,7746616
0400000US17,17,Illinois,,2013,1120,Fire Protection Total ,0,0,0,0,0,0,0,0
0400000US17,17,Illinois,,2013,1121,Fire Protection - Firefighters,0,0,0,0,0,0,0,0
0400000US17,17,Illinois,,2013,1122,Fire Protection - Other ,0,0,0,0,0,0,0,0
0400000US17,17,Illinois,,2013,1140,Corrections,10937,61706246,0,0,0,10937,10937,61706246
0400000US17,17,Illinois,,2013,1160,Highways,5994,36601061,1550,5992805,173856,7041,7544,42593866
0400000US17,17,Illinois,,2013,1180,Air Transportation,0,0,0,0,0,0,0,0
0400000US17,17,Illinois,,2013,1200,Water Transport and Terminals       ,45,285998,0,0,0,45,45,285998
0400000US17,17,Illinois,,2013,1220,Public Welfare,8989,49864022,51,172838,4408,9015,9040,50036860
0400000US17,17,Illinois,,2013,1240,Health,2214,14650103,20,64113,1384,2223,2234,14714216
0400000US17,17,Illinois,,2013,1260,Hospitals,9517,50722196,621,1614013,52815,9815,10138,52336209
0400000US17,17,Illinois,,2013,1280,Social Insurance Administration,1648,9748151,192,389267,14492,1735,1840,10137418
0400000US17,17,Illinois,,2013,1300,Solid Waste Management,0,0,0,0,0,0,0,0
0400000US17,17,Illinois,,2013,1320,Sewerage,0,0,0,0,0,0,0,0
0400000US17,17,Illinois,,2013,1340,Parks and Recreation,364,1801368,26,78162,3578,385,390,1879530
0400000US17,17,Illinois,,2013,1360,Housing and Community Development,0,0,0,0,0,0,0,0
0400000US17,17,Illinois,,2013,1380,Natural Resources,2147,10769150,1314,3464040,218431,3383,3461,14233190
0400000US17,17,Illinois,,2013,1400,Water Supply,0,0,0,0,0,0,0,0
0400000US17,17,Illinois,,2013,1420,Electric Power,0,0,0,0,0,0,0,0
0400000US17,17,Illinois,,2013,1440,Gas Supply,0,0,0,0,0,0,0,0
0400000US17,17,Illinois,,2013,1460,Transit,0,0,0,0,0,0,0,0
0400000US17,17,Illinois,,2013,1480,Education Total ,40816,217231012,48361,76427836,4006031,63853,89177,293658848
0400000US17,17,Illinois,,2013,1481,Education - Elementary and Secondary Total ,0,0,0,0,0,0,0,0
0400000US17,17,Illinois,,2013,14811,Education - Elementary and Secondary Instructional             ,0,0,0,0,0,0,0,0
0400000US17,17,Illinois,,2013,14812,Education - Elementary and Secondary Other ,0,0,0,0,0,0,0,0
0400000US17,17,Illinois,,2013,1482,Education - Higher Education Total ,39107,208477598,48342,76366182,4004308,62134,87449,284843780
0400000US17,17,Illinois,,2013,14821,Education - Higher Education Instructional,12948,85497782,18021,36143666,1414599,21130,30969,121641448
0400000US17,17,Illinois,,2013,14822,Education - Higher Education Other ,26159,122979816,30321,40222516,2589709,41004,56480,163202332
0400000US17,17,Illinois,,2013,1483,Education - Other,1709,8753414,19,61654,1723,1719,1728,8815068
0400000US17,17,Illinois,,2013,1500,Libraries                          ,0,0,0,0,0,0,0,0
0400000US17,17,Illinois,,2013,1560,State liquor stores,0,0,0,0,0,0,0,0
0400000US17,17,Illinois,,2013,1580,All other and unallocable,6039,33513184,192,453618,18336,6150,6231,33966802
0400000US18,18,Indiana,,2013,1000,Total - All Government Employment Functions,71956,315137359,38611,31719776,2132421,84101,110567,346857135
0400000US18,18,Indiana,,2013,1020,Financial Administration,1816,8082625,21,36527,1775,1825,1837,8119152
0400000US18,18,Indiana,,2013,1040,Other Government Administration,551,2488912,329,568765,35687,766,880,3057677
0400000US18,18,Indiana,,2013,1060,Judicial and Legal,1403,9554434,57,88803,4746,1432,1460,9643237
0400000US18,18,Indiana,,2013,1100,Police Protection Total,1900,8643631,0,0,0,1900,1900,8643631
0400000US18,18,Indiana,,2013,1101,Police Protection - Persons with Power of Arrest       ,1325,6649237,0,0,0,1325,1325,6649237
0400000US18,18,Indiana,,2013,1102,Police Protection - Other ,575,1994394,0,0,0,575,575,1994394
0400000US18,18,Indiana,,2013,1120,Fire Protection Total ,0,0,0,0,0,0,0,0
0400000US18,18,Indiana,,2013,1121,Fire Protection - Firefighters,0,0,0,0,0,0,0,0
0400000US18,18,Indiana,,2013,1122,Fire Protection - Other ,0,0,0,0,0,0,0,0
0400000US18,18,Indiana,,2013,1140,Corrections,6287,19756870,1,1216,100,6288,6288,19758086
0400000US18,18,Indiana,,2013,1160,Highways,3573,13290384,141,285605,18341,3683,3714,13575989
0400000US18,18,Indiana,,2013,1180,Air Transportation,0,0,0,0,0,0,0,0
0400000US18,18,Indiana,,2013,1200,Water Transport and Terminals       ,29,160942,8,5000,80,29,37,165942
0400000US18,18,Indiana,,2013,1220,Public Welfare,4758,16753825,30,43916,3297,4777,4788,16797741
0400000US18,18,Indiana,,2013,1240,Health,1678,6879252,8,19692,664,1682,1686,6898944
0400000US18,18,Indiana,,2013,1260,Hospitals,1891,6287079,22,29645,1764,1901,1913,6316724
0400000US18,18,Indiana,,2013,1280,Social Insurance Administration,1270,3984470,98,130158,11048,1336,1368,4114628
0400000US18,18,Indiana,,2013,1300,Solid Waste Management,0,0,0,0,0,0,0,0
0400000US18,18,Indiana,,2013,1320,Sewerage,0,0,0,0,0,0,0,0
0400000US18,18,Indiana,,2013,1340,Parks and Recreation,131,456437,46,43278,3915,154,177,499715
0400000US18,18,Indiana,,2013,1360,Housing and Community Development,0,0,0,0,0,0,0,0
0400000US18,18,Indiana,,2013,1380,Natural Resources,2046,7413626,229,270839,18840,2156,2275,7684465
0400000US18,18,Indiana,,2013,1400,Water Supply,0,0,0,0,0,0,0,0
0400000US18,18,Indiana,,2013,1420,Electric Power,0,0,0,0,0,0,0,0
0400000US18,18,Indiana,,2013,1440,Gas Supply,0,0,0,0,0,0,0,0
0400000US18,18,Indiana,,2013,1460,Transit,0,0,0,0,0,0,0,0
0400000US18,18,Indiana,,2013,1480,Education Total ,42323,202460820,37455,30040415,2020953,53803,79778,232501235
0400000US18,18,Indiana,,2013,1481,Education - Elementary and Secondary Total ,0,0,0,0,0,0,0,0
0400000US18,18,Indiana,,2013,14811,Education - Elementary and Secondary Instructional             ,0,0,0,0,0,0,0,0
0400000US18,18,Indiana,,2013,14812,Education - Elementary and Secondary Other ,0,0,0,0,0,0,0,0
0400000US18,18,Indiana,,2013,1482,Education - Higher Education Total ,41368,198789940,37330,29964381,2014968,52811,78698,228754321
0400000US18,18,Indiana,,2013,14821,Education - Higher Education Instructional,17631,107178877,11536,16204468,801232,22169,29167,123383345
0400000US18,18,Indiana,,2013,14822,Education - Higher Education Other ,23737,91611063,25794,13759913,1213736,30642,49531,105370976
0400000US18,18,Indiana,,2013,1483,Education - Other,955,3670880,125,76034,5985,992,1080,3746914
0400000US18,18,Indiana,,2013,1500,Libraries                          ,0,0,0,0,0,0,0,0
0400000US18,18,Indiana,,2013,1560,State liquor stores,0,0,0,0,0,0,0,0
0400000US18,18,Indiana,,2013,1580,All other and unallocable,2300,8924052,166,155917,11211,2369,2466,9079969
0400000US19,19,Iowa,,2013,1000,Total - All Government Employment Functions,40504,242971841,26861,23351030,1650751,49833,67365,266322871
0400000US19,19,Iowa,,2013,1020,Financial Administration,986,5049849,37,99534,4564,1012,1023,5149383
0400000US19,19,Iowa,,2013,1040,Other Government Administration,358,1915313,254,445285,31412,536,612,2360598
0400000US19,19,Iowa,,2013,1060,Judicial and Legal,2139,11842235,103,285058,11585,2204,2242,12127293
0400000US19,19,Iowa,,2013,1100,Police Protection Total,935,5344325,18,17496,852,940,953,5361821
0400000US19,19,Iowa,,2013,1101,Police Protection - Persons with Power of Arrest       ,646,3827989,2,1008,55,646,648,3828997
0400000US19,19,Iowa,,2013,1102,Police Protection - Other ,289,1516336,16,16488,797,294,305,1532824
0400000US19,19,Iowa,,2013,1120,Fire Protection Total ,0,0,0,0,0,0,0,0
0400000US19,19,Iowa,,2013,1121,Fire Protection - Firefighters,0,0,0,0,0,0,0,0
0400000US19,19,Iowa,,2013,1122,Fire Protection - Other ,0,0,0,0,0,0,0,0
0400000US19,19,Iowa,,2013,1140,Corrections,2847,14261284,186,589630,21421,2969,3033,14850914
0400000US19,19,Iowa,,2013,1160,Highways,2203,11138608,0,0,0,2203,2203,11138608
0400000US19,19,Iowa,,2013,1180,Air Transportation,0,0,0,0,0,0,0,0
0400000US19,19,Iowa,,2013,1200,Water Transport and Terminals       ,0,0,0,0,0,0,0,0
0400000US19,19,Iowa,,2013,1220,Public Welfare,2680,13143597,73,208054,8778,2729,2753,13351651
0400000US19,19,Iowa,,2013,1240,Health,407,2424574,58,101877,4291,431,465,2526451
0400000US19,19,Iowa,,2013,1260,Hospitals,5806,40371583,4059,3201426,171963,6777,9865,43573009
0400000US19,19,Iowa,,2013,1280,Social Insurance Administration,723,3486167,3,7938,392,725,726,3494105
0400000US19,19,Iowa,,2013,1300,Solid Waste Management,0,0,0,0,0,0,0,0
0400000US19,19,Iowa,,2013,1320,Sewerage,0,0,0,0,0,0,0,0
0400000US19,19,Iowa,,2013,1340,Parks and Recreation,98,566425,11,13799,1523,107,109,580224
0400000US19,19,Iowa,,2013,1360,Housing and Community Development,0,0,0,0,0,0,0,0
0400000US19,19,Iowa,,2013,1380,Natural Resources,1496,8146409,205,253746,18450,1599,1701,8400155
0400000US19,19,Iowa,,2013,1400,Water Supply,0,0,0,0,0,0,0,0
0400000US19,19,Iowa,,2013,1420,Electric Power,0,0,0,0,0,0,0,0
0400000US19,19,Iowa,,2013,1440,Gas Supply,0,0,0,0,0,0,0,0
0400000US19,19,Iowa,,2013,1460,Transit,0,0,0,0,0,0,0,0
0400000US19,19,Iowa,,2013,1480,Education Total ,17211,111179441,21554,17408116,1341630,24793,38765,128587557
0400000US19,19,Iowa,,2013,1481,Education - Elementary and Secondary Total ,0,0,0,0,0,0,0,0
0400000US19,19,Iowa,,2013,14811,Education - Elementary and Secondary Instructional             ,0,0,0,0,0,0,0,0
0400000US19,19,Iowa,,2013,14812,Education - Elementary and Secondary Other ,0,0,0,0,0,0,0,0
0400000US19,19,Iowa,,2013,1482,Education - Higher Education Total ,16153,105330104,21475,17266292,1335303,23697,37628,122596396
0400000US19,19,Iowa,,2013,14821,Education - Higher Education Instructional,3659,36606836,7017,11511328,433490,6108,10676,48118164
0400000US19,19,Iowa,,2013,14822,Education - Higher Education Other ,12494,68723268,14458,5754964,901813,17589,26952,74478232
0400000US19,19,Iowa,,2013,1483,Education - Other,1058,5849337,79,141824,6327,1096,1137,5991161
0400000US19,19,Iowa,,2013,1500,Libraries                          ,0,0,0,0,0,0,0,0
0400000US19,19,Iowa,,2013,1560,State liquor stores,0,0,0,0,0,0,0,0
0400000US19,19,Iowa,,2013,1580,All other and unallocable,2615,14102031,300,719071,33890,2808,2915,14821102
0400000US20,20,Kansas,,2013,1000,Total - All Government Employment Functions,44256,197164146,16844,17945409,943388,49640,61100,215109555
0400000US20,20,Kansas,,2013,1020,Financial Administration,1690,6683259,82,116736,5111,1720,1772,6799995
0400000US20,20,Kansas,,2013,1040,Other Government Administration,455,1514196,188,453615,18661,561,643,1967811
0400000US20,20,Kansas,,2013,1060,Judicial and Legal,2069,8753484,104,130000,7439,2111,2173,8883484
0400000US20,20,Kansas,,2013,1100,Police Protection Total,1045,4562379,57,87933,4850,1073,1102,4650312
0400000US20,20,Kansas,,2013,1101,Police Protection - Persons with Power of Arrest       ,291,1490155,23,46382,2301,304,314,1536537
0400000US20,20,Kansas,,2013,1102,Police Protection - Other ,754,3072224,34,41551,2549,769,788,3113775
0400000US20,20,Kansas,,2013,1120,Fire Protection Total ,0,0,0,0,0,0,0,0
0400000US20,20,Kansas,,2013,1121,Fire Protection - Firefighters,0,0,0,0,0,0,0,0
0400000US20,20,Kansas,,2013,1122,Fire Protection - Other ,0,0,0,0,0,0,0,0
0400000US20,20,Kansas,,2013,1140,Corrections,3391,10671151,17,25012,1380,3399,3408,10696163
0400000US20,20,Kansas,,2013,1160,Highways,2881,10590050,108,132742,8684,2930,2989,10722792
0400000US20,20,Kansas,,2013,1180,Air Transportation,0,0,0,0,0,0,0,0
0400000US20,20,Kansas,,2013,1200,Water Transport and Terminals       ,0,0,0,0,0,0,0,0
0400000US20,20,Kansas,,2013,1220,Public Welfare,2215,7363214,54,47269,4790,2242,2269,7410483
0400000US20,20,Kansas,,2013,1240,Health,1012,4160481,25,50610,1970,1023,1037,4211091
0400000US20,20,Kansas,,2013,1260,Hospitals,7158,31633741,1766,4268255,150844,8064,8924,35901996
0400000US20,20,Kansas,,2013,1280,Social Insurance Administration,96,339521,1,204,33,96,97,339725
0400000US20,20,Kansas,,2013,1300,Solid Waste Management,0,0,0,0,0,0,0,0
0400000US20,20,Kansas,,2013,1320,Sewerage,0,0,0,0,0,0,0,0
0400000US20,20,Kansas,,2013,1340,Parks and Recreation,613,1745380,1,436,35,613,614,1745816
0400000US20,20,Kansas,,2013,1360,Housing and Community Development,0,0,0,0,0,0,0,0
0400000US20,20,Kansas,,2013,1380,Natural Resources,761,3192747,83,108607,7395,803,844,3301354
0400000US20,20,Kansas,,2013,1400,Water Supply,0,0,0,0,0,0,0,0
0400000US20,20,Kansas,,2013,1420,Electric Power,0,0,0,0,0,0,0,0
0400000US20,20,Kansas,,2013,1440,Gas Supply,0,0,0,0,0,0,0,0
0400000US20,20,Kansas,,2013,1460,Transit,0,0,0,0,0,0,0,0
0400000US20,20,Kansas,,2013,1480,Education Total ,17911,94248942,14106,12207313,718305,21969,32017,106456255
0400000US20,20,Kansas,,2013,1481,Education - Elementary and Secondary Total ,0,0,0,0,0,0,0,0
0400000US20,20,Kansas,,2013,14811,Education - Elementary and Secondary Instructional             ,0,0,0,0,0,0,0,0
0400000US20,20,Kansas,,2013,14812,Education - Elementary and Secondary Other ,0,0,0,0,0,0,0,0
0400000US20,20,Kansas,,2013,1482,Education - Higher Education Total ,17272,91561205,14032,12114326,714301,21307,31304,103675531
0400000US20,20,Kansas,,2013,14821,Education - Higher Education Instructional,6376,47068663,3791,6067128,235987,7709,10167,53135791
0400000US20,20,Kansas,,2013,14822,Education - Higher Education Other ,10896,44492542,10241,6047198,478314,13598,21137,50539740
0400000US20,20,Kansas,,2013,1483,Education - Other,639,2687737,74,92987,4004,662,713,2780724
0400000US20,20,Kansas,,2013,1500,Libraries                          ,0,0,0,0,0,0,0,0
0400000US20,20,Kansas,,2013,1560,State liquor stores,0,0,0,0,0,0,0,0
0400000US20,20,Kansas,,2013,1580,All other and unallocable,2959,11705601,252,316677,13891,3036,3211,12022278
0400000US21,21,Kentucky,,2013,1000,Total - All Government Employment Functions,74688,301419619,25022,25566227,1802175,85277,99710,326985846
0400000US21,21,Kentucky,,2013,1020,Financial Administration,2642,10167706,25,26988,1021,2649,2667,10194694
0400000US21,21,Kentucky,,2013,1040,Other Government Administration,652,3237895,178,629547,26381,811,830,3867442
0400000US21,21,Kentucky,,2013,1060,Judicial and Legal,5510,19644016,171,261924,16771,5611,5681,19905940
0400000US21,21,Kentucky,,2013,1100,Police Protection Total,2116,8417482,6,7290,452,2119,2122,8424772
0400000US21,21,Kentucky,,2013,1101,Police Protection - Persons with Power of Arrest       ,1085,4842699,1,483,20,1085,1086,4843182
0400000US21,21,Kentucky,,2013,1102,Police Protection - Other ,1031,3574783,5,6807,432,1034,1036,3581590
0400000US21,21,Kentucky,,2013,1120,Fire Protection Total ,0,0,0,0,0,0,0,0
0400000US21,21,Kentucky,,2013,1121,Fire Protection - Firefighters,0,0,0,0,0,0,0,0
0400000US21,21,Kentucky,,2013,1122,Fire Protection - Other ,0,0,0,0,0,0,0,0
0400000US21,21,Kentucky,,2013,1140,Corrections,4311,11391346,5,6802,432,4314,4316,11398148
0400000US21,21,Kentucky,,2013,1160,Highways,4518,14627196,16,34532,1233,4525,4534,14661728
0400000US21,21,Kentucky,,2013,1180,Air Transportation,0,0,0,0,0,0,0,0
0400000US21,21,Kentucky,,2013,1200,Water Transport and Terminals       ,0,0,0,0,0,0,0,0
0400000US21,21,Kentucky,,2013,1220,Public Welfare,7598,23382202,46,73844,3639,7619,7644,23456046
0400000US21,21,Kentucky,,2013,1240,Health,3091,12722943,61,76870,3330,3109,3152,12799813
0400000US21,21,Kentucky,,2013,1260,Hospitals,5362,23243749,692,1435314,60078,5701,6054,24679063
0400000US21,21,Kentucky,,2013,1280,Social Insurance Administration,1284,3924345,25,43895,2355,1298,1309,3968240
0400000US21,21,Kentucky,,2013,1300,Solid Waste Management,0,0,0,0,0,0,0,0
0400000US21,21,Kentucky,,2013,1320,Sewerage,0,0,0,0,0,0,0,0
0400000US21,21,Kentucky,,2013,1340,Parks and Recreation,1045,2506238,11,9570,976,1051,1056,2515808
0400000US21,21,Kentucky,,2013,1360,Housing and Community Development,0,0,0,0,0,0,0,0
0400000US21,21,Kentucky,,2013,1380,Natural Resources,2742,11355659,76,168520,7958,2787,2818,11524179
0400000US21,21,Kentucky,,2013,1400,Water Supply,0,0,0,0,0,0,0,0
0400000US21,21,Kentucky,,2013,1420,Electric Power,0,0,0,0,0,0,0,0
0400000US21,21,Kentucky,,2013,1440,Gas Supply,0,0,0,0,0,0,0,0
0400000US21,21,Kentucky,,2013,1460,Transit,0,0,0,0,0,0,0,0
0400000US21,21,Kentucky,,2013,1480,Education Total ,31060,146638431,23609,22732423,1675346,40914,54669,169370854
0400000US21,21,Kentucky,,2013,1481,Education - Elementary and Secondary Total ,0,0,0,0,0,0,0,0
0400000US21,21,Kentucky,,2013,14811,Education - Elementary and Secondary Instructional             ,0,0,0,0,0,0,0,0
0400000US21,21,Kentucky,,2013,14812,Education - Elementary and Secondary Other ,0,0,0,0,0,0,0,0
0400000US21,21,Kentucky,,2013,1482,Education - Higher Education Total ,28834,137771050,23210,22366476,1658039,38586,52044,160137526
0400000US21,21,Kentucky,,2013,14821,Education - Higher Education Instructional,9146,65760230,7768,11072050,550361,12384,16914,76832280
0400000US21,21,Kentucky,,2013,14822,Education - Higher Education Other ,19688,72010820,15442,11294426,1107678,26202,35130,83305246
0400000US21,21,Kentucky,,2013,1483,Education - Other,2226,8867381,399,365947,17307,2328,2625,9233328
0400000US21,21,Kentucky,,2013,1500,Libraries                          ,0,0,0,0,0,0,0,0
0400000US21,21,Kentucky,,2013,1560,State liquor stores,0,0,0,0,0,0,0,0
0400000US21,21,Kentucky,,2013,1580,All other and unallocable,2757,10160411,101,58708,2203,2769,2858,10219119
0400000US22,22,Louisiana,,2013,1000,Total - All Government Employment Functions,68860,302529002,21602,21154230,1378302,76806,90462,323683232
0400000US22,22,Louisiana,,2013,1020,Financial Administration,2025,8573667,130,187463,12848,2097,2155,8761130
0400000US22,22,Louisiana,,2013,1040,Other Government Administration,2040,9530496,471,630540,37335,2251,2511,10161036
0400000US22,22,Louisiana,,2013,1060,Judicial and Legal,1694,7464370,64,72087,3494,1714,1758,7536457
0400000US22,22,Louisiana,,2013,1100,Police Protection Total,1706,9157926,65,149377,6503,1743,1771,9307303
0400000US22,22,Louisiana,,2013,1101,Police Protection - Persons with Power of Arrest       ,1151,6949565,31,80523,3096,1168,1182,7030088
0400000US22,22,Louisiana,,2013,1102,Police Protection - Other ,555,2208361,34,68854,3407,575,589,2277215
0400000US22,22,Louisiana,,2013,1120,Fire Protection Total ,0,0,0,0,0,0,0,0
0400000US22,22,Louisiana,,2013,1121,Fire Protection - Firefighters,0,0,0,0,0,0,0,0
0400000US22,22,Louisiana,,2013,1122,Fire Protection - Other ,0,0,0,0,0,0,0,0
0400000US22,22,Louisiana,,2013,1140,Corrections,5830,22768185,110,192211,15626,5918,5940,22960396
0400000US22,22,Louisiana,,2013,1160,Highways,4549,17771063,36,44212,2966,4566,4585,17815275
0400000US22,22,Louisiana,,2013,1180,Air Transportation,0,0,0,0,0,0,0,0
0400000US22,22,Louisiana,,2013,1200,Water Transport and Terminals       ,274,1467797,0,0,0,274,274,1467797
0400000US22,22,Louisiana,,2013,1220,Public Welfare,5105,19247351,181,266337,15606,5193,5286,19513688
0400000US22,22,Louisiana,,2013,1240,Health,2345,11257485,49,79813,3765,2367,2394,11337298
0400000US22,22,Louisiana,,2013,1260,Hospitals,9390,36756237,996,1549525,99207,9950,10386,38305762
0400000US22,22,Louisiana,,2013,1280,Social Insurance Administration,1099,4033713,77,90507,7046,1139,1176,4124220
0400000US22,22,Louisiana,,2013,1300,Solid Waste Management,0,0,0,0,0,0,0,0
0400000US22,22,Louisiana,,2013,1320,Sewerage,0,0,0,0,0,0,0,0
0400000US22,22,Louisiana,,2013,1340,Parks and Recreation,862,2829703,272,331481,28907,1025,1134,3161184
0400000US22,22,Louisiana,,2013,1360,Housing and Community Development,0,0,0,0,0,0,0,0
0400000US22,22,Louisiana,,2013,1380,Natural Resources,3817,16153225,787,812340,60326,4172,4604,16965565
0400000US22,22,Louisiana,,2013,1400,Water Supply,0,0,0,0,0,0,0,0
0400000US22,22,Louisiana,,2013,1420,Electric Power,0,0,0,0,0,0,0,0
0400000US22,22,Louisiana,,2013,1440,Gas Supply,0,0,0,0,0,0,0,0
0400000US22,22,Louisiana,,2013,1460,Transit,0,0,0,0,0,0,0,0
0400000US22,22,Louisiana,,2013,1480,Education Total ,25491,124432061,18216,16576864,1075092,31710,43707,141008925
0400000US22,22,Louisiana,,2013,1481,Education - Elementary and Secondary Total ,1394,6057237,161,321337,9107,1445,1555,6378574
0400000US22,22,Louisiana,,2013,14811,Education - Elementary and Secondary Instructional             ,1205,5125536,129,224004,6634,1242,1334,5349540
0400000US22,22,Louisiana,,2013,14812,Education - Elementary and Secondary Other ,189,931701,32,97333,2473,203,221,1029034
0400000US22,22,Louisiana,,2013,1482,Education - Higher Education Total ,21566,107337537,17469,15482002,1031916,27539,39035,122819539
0400000US22,22,Louisiana,,2013,14821,Education - Higher Education Instructional,7297,51777972,5833,8405541,416143,9696,13130,60183513
0400000US22,22,Louisiana,,2013,14822,Education - Higher Education Other ,14269,55559565,11636,7076461,615773,17843,25905,62636026
0400000US22,22,Louisiana,,2013,1483,Education - Other,2531,11037287,586,773525,34069,2726,3117,11810812
0400000US22,22,Louisiana,,2013,1500,Libraries                          ,0,0,0,0,0,0,0,0
0400000US22,22,Louisiana,,2013,1560,State liquor stores,0,0,0,0,0,0,0,0
0400000US22,22,Louisiana,,2013,1580,All other and unallocable,2633,11085723,148,171473,9581,2687,2781,11257196
0400000US23,23,Maine,,2013,1000,Total - All Government Employment Functions,18744,78038381,8298,8029736,424204,21152,27042,86068117
0400000US23,23,Maine,,2013,1020,Financial Administration,1320,4972723,16,50546,1936,1331,1336,5023269
0400000US23,23,Maine,,2013,1040,Other Government Administration,285,1351417,201,509456,21793,408,486,1860873
0400000US23,23,Maine,,2013,1060,Judicial and Legal,654,3867905,122,406975,16540,748,776,4274880
0400000US23,23,Maine,,2013,1100,Police Protection Total,543,2678582,2,4767,217,544,545,2683349
0400000US23,23,Maine,,2013,1101,Police Protection - Persons with Power of Arrest       ,315,1738522,0,0,0,315,315,1738522
0400000US23,23,Maine,,2013,1102,Police Protection - Other ,228,940060,2,4767,217,229,230,944827
0400000US23,23,Maine,,2013,1120,Fire Protection Total ,0,0,0,0,0,0,0,0
0400000US23,23,Maine,,2013,1121,Fire Protection - Firefighters,0,0,0,0,0,0,0,0
0400000US23,23,Maine,,2013,1122,Fire Protection - Other ,0,0,0,0,0,0,0,0
0400000US23,23,Maine,,2013,1140,Corrections,1135,4549737,34,65309,3093,1152,1169,4615046
0400000US23,23,Maine,,2013,1160,Highways,2003,7376419,124,199740,10602,2063,2127,7576159
0400000US23,23,Maine,,2013,1180,Air Transportation,0,0,0,0,0,0,0,0
0400000US23,23,Maine,,2013,1200,Water Transport and Terminals       ,67,252747,25,42266,3494,87,92,295013
0400000US23,23,Maine,,2013,1220,Public Welfare,2665,9523628,59,130926,6023,2699,2724,9654554
0400000US23,23,Maine,,2013,1240,Health,973,4116842,26,87189,3049,990,999,4204031
0400000US23,23,Maine,,2013,1260,Hospitals,433,1795808,37,113068,4048,455,470,1908876
0400000US23,23,Maine,,2013,1280,Social Insurance Administration,391,1426992,3,8253,345,393,394,1435245
0400000US23,23,Maine,,2013,1300,Solid Waste Management,0,0,0,0,0,0,0,0
0400000US23,23,Maine,,2013,1320,Sewerage,0,0,0,0,0,0,0,0
0400000US23,23,Maine,,2013,1340,Parks and Recreation,167,584279,2,4187,160,167,169,588466
0400000US23,23,Maine,,2013,1360,Housing and Community Development,0,0,0,0,0,0,0,0
0400000US23,23,Maine,,2013,1380,Natural Resources,962,4087457,203,320459,11380,1026,1165,4407916
0400000US23,23,Maine,,2013,1400,Water Supply,0,0,0,0,0,0,0,0
0400000US23,23,Maine,,2013,1420,Electric Power,0,0,0,0,0,0,0,0
0400000US23,23,Maine,,2013,1440,Gas Supply,0,0,0,0,0,0,0,0
0400000US23,23,Maine,,2013,1460,Transit,0,0,0,0,0,0,0,0
0400000US23,23,Maine,,2013,1480,Education Total ,5693,25115809,7391,5974342,336927,7610,13084,31090151
0400000US23,23,Maine,,2013,1481,Education - Elementary and Secondary Total ,21,69030,36,53827,3944,43,57,122857
0400000US23,23,Maine,,2013,14811,Education - Elementary and Secondary Instructional             ,15,56256,16,23192,1621,24,31,79448
0400000US23,23,Maine,,2013,14812,Education - Elementary and Secondary Other ,6,12774,20,30635,2323,19,26,43409
0400000US23,23,Maine,,2013,1482,Education - Higher Education Total ,5437,24094915,7355,5920515,332983,7332,12792,30015430
0400000US23,23,Maine,,2013,14821,Education - Higher Education Instructional,1708,10024010,2702,3474919,132217,2464,4410,13498929
0400000US23,23,Maine,,2013,14822,Education - Higher Education Other ,3729,14070905,4653,2445596,200766,4868,8382,16516501
0400000US23,23,Maine,,2013,1483,Education - Other,235,951864,0,0,0,235,235,951864
0400000US23,23,Maine,,2013,1500,Libraries                          ,0,0,0,0,0,0,0,0
0400000US23,23,Maine,,2013,1560,State liquor stores,1,4444,0,0,0,1,1,4444
0400000US23,23,Maine,,2013,1580,All other and unallocable,1452,6333592,53,112253,4597,1478,1505,6445845
0400000US24,24,Maryland,,2013,1000,Total - All Government Employment Functions,77933,379549631,14020,39496590,1594054,86943,91953,419046221
0400000US24,24,Maryland,,2013,1020,Financial Administration,2999,13446173,161,347524,19405,3109,3160,13793697
0400000US24,24,Maryland,,2013,1040,Other Government Administration,1444,7849206,295,560071,20474,1560,1739,8409277
0400000US24,24,Maryland,,2013,1060,Judicial and Legal,4740,26465279,478,1172974,66577,5116,5218,27638253
0400000US24,24,Maryland,,2013,1100,Police Protection Total,2211,11696386,0,0,0,2211,2211,11696386
0400000US24,24,Maryland,,2013,1101,Police Protection - Persons with Power of Arrest       ,1452,8485364,0,0,0,1452,1452,8485364
0400000US24,24,Maryland,,2013,1102,Police Protection - Other ,759,3211022,0,0,0,759,759,3211022
0400000US24,24,Maryland,,2013,1120,Fire Protection Total ,0,0,0,0,0,0,0,0
0400000US24,24,Maryland,,2013,1121,Fire Protection - Firefighters,0,0,0,0,0,0,0,0
0400000US24,24,Maryland,,2013,1122,Fire Protection - Other ,0,0,0,0,0,0,0,0
0400000US24,24,Maryland,,2013,1140,Corrections,12326,52576596,550,1249975,79637,12776,12876,53826571
0400000US24,24,Maryland,,2013,1160,Highways,4526,21653044,0,0,0,4526,4526,21653044
0400000US24,24,Maryland,,2013,1180,Air Transportation,468,2456278,0,0,0,468,468,2456278
0400000US24,24,Maryland,,2013,1200,Water Transport and Terminals       ,270,1587134,0,0,0,270,270,1587134
0400000US24,24,Maryland,,2013,1220,Public Welfare,6431,26116101,198,452863,25798,6578,6629,26568964
0400000US24,24,Maryland,,2013,1240,Health,5378,24934441,811,1777875,102887,5959,6189,26712316
0400000US24,24,Maryland,,2013,1260,Hospitals,3411,14561824,468,821923,38806,3630,3879,15383747
0400000US24,24,Maryland,,2013,1280,Social Insurance Administration,914,3997180,150,372711,21720,1037,1064,4369891
0400000US24,24,Maryland,,2013,1300,Solid Waste Management,0,0,0,0,0,0,0,0
0400000US24,24,Maryland,,2013,1320,Sewerage,0,0,0,0,0,0,0,0
0400000US24,24,Maryland,,2013,1340,Parks and Recreation,356,1578832,91,144549,7834,400,447,1723381
0400000US24,24,Maryland,,2013,1360,Housing and Community Development,0,0,0,0,0,0,0,0
0400000US24,24,Maryland,,2013,1380,Natural Resources,1804,9349749,304,731765,36991,2013,2108,10081514
0400000US24,24,Maryland,,2013,1400,Water Supply,0,0,0,0,0,0,0,0
0400000US24,24,Maryland,,2013,1420,Electric Power,0,0,0,0,0,0,0,0
0400000US24,24,Maryland,,2013,1440,Gas Supply,0,0,0,0,0,0,0,0
0400000US24,24,Maryland,,2013,1460,Transit,715,3967836,0,0,0,715,715,3967836
0400000US24,24,Maryland,,2013,1480,Education Total ,23991,129226570,9949,30378429,1102222,30220,33940,159604999
0400000US24,24,Maryland,,2013,1481,Education - Elementary and Secondary Total ,0,0,0,0,0,0,0,0
0400000US24,24,Maryland,,2013,14811,Education - Elementary and Secondary Instructional             ,0,0,0,0,0,0,0,0
0400000US24,24,Maryland,,2013,14812,Education - Elementary and Secondary Other ,0,0,0,0,0,0,0,0
0400000US24,24,Maryland,,2013,1482,Education - Higher Education Total ,22195,120388113,9577,29288390,1057814,28173,31772,149676503
0400000US24,24,Maryland,,2013,14821,Education - Higher Education Instructional,7056,53979762,4457,22675573,635049,10644,11513,76655335
0400000US24,24,Maryland,,2013,14822,Education - Higher Education Other ,15139,66408351,5120,6612817,422765,17529,20259,73021168
0400000US24,24,Maryland,,2013,1483,Education - Other,1796,8838457,372,1090039,44408,2047,2168,9928496
0400000US24,24,Maryland,,2013,1500,Libraries                          ,0,0,0,0,0,0,0,0
0400000US24,24,Maryland,,2013,1560,State liquor stores,0,0,0,0,0,0,0,0
0400000US24,24,Maryland,,2013,1580,All other and unallocable,5949,28087002,565,1485931,71703,6355,6514,29572933
0400000US25,25,Massachusetts,,2013,1000,Total - All Government Employment Functions,87275,476055419,33845,46889181,1657798,97203,121120,522944600
0400000US25,25,Massachusetts,,2013,1020,Financial Administration,3844,20944057,272,962843,14921,3932,4116,21906900
0400000US25,25,Massachusetts,,2013,1040,Other Government Administration,1749,8114112,289,1251349,24580,1894,2038,9365461
0400000US25,25,Massachusetts,,2013,1060,Judicial and Legal,8981,49728825,406,1377507,21106,9107,9387,51106332
0400000US25,25,Massachusetts,,2013,1100,Police Protection Total,2820,24371077,22,93901,1554,2828,2842,24464978
0400000US25,25,Massachusetts,,2013,1101,Police Protection - Persons with Power of Arrest       ,2042,19827842,1,2128,49,2042,2043,19829970
0400000US25,25,Massachusetts,,2013,1102,Police Protection - Other ,778,4543235,21,91773,1505,786,799,4635008
0400000US25,25,Massachusetts,,2013,1120,Fire Protection Total ,0,0,0,0,0,0,0,0
0400000US25,25,Massachusetts,,2013,1121,Fire Protection - Firefighters,0,0,0,0,0,0,0,0
0400000US25,25,Massachusetts,,2013,1122,Fire Protection - Other ,0,0,0,0,0,0,0,0
0400000US25,25,Massachusetts,,2013,1140,Corrections,11951,60659706,133,395481,6619,11991,12084,61055187
0400000US25,25,Massachusetts,,2013,1160,Highways,3115,17445423,43,180145,3333,3135,3158,17625568
0400000US25,25,Massachusetts,,2013,1180,Air Transportation,1002,6967914,0,0,0,1002,1002,6967914
0400000US25,25,Massachusetts,,2013,1200,Water Transport and Terminals       ,160,1106248,0,0,0,160,160,1106248
0400000US25,25,Massachusetts,,2013,1220,Public Welfare,6657,35433654,468,1560498,26349,6815,7125,36994152
0400000US25,25,Massachusetts,,2013,1240,Health,6620,32524527,826,1936318,61925,6992,7446,34460845
0400000US25,25,Massachusetts,,2013,1260,Hospitals,5273,21692749,558,1660194,46641,5555,5831,23352943
0400000US25,25,Massachusetts,,2013,1280,Social Insurance Administration,1447,7223314,44,193347,3078,1466,1491,7416661
0400000US25,25,Massachusetts,,2013,1300,Solid Waste Management,0,0,0,0,0,0,0,0
0400000US25,25,Massachusetts,,2013,1320,Sewerage,769,5129216,34,187740,2600,785,803,5316956
0400000US25,25,Massachusetts,,2013,1340,Parks and Recreation,891,4436166,126,147126,9185,944,1017,4583292
0400000US25,25,Massachusetts,,2013,1360,Housing and Community Development,0,0,0,0,0,0,0,0
0400000US25,25,Massachusetts,,2013,1380,Natural Resources,1109,6684971,121,412752,6572,1149,1230,7097723
0400000US25,25,Massachusetts,,2013,1400,Water Supply,531,3281326,18,64768,1694,542,549,3346094
0400000US25,25,Massachusetts,,2013,1420,Electric Power,0,0,0,0,0,0,0,0
0400000US25,25,Massachusetts,,2013,1440,Gas Supply,0,0,0,0,0,0,0,0
0400000US25,25,Massachusetts,,2013,1460,Transit,0,0,0,0,0,0,0,0
0400000US25,25,Massachusetts,,2013,1480,Education Total ,26264,145655344,30268,35608682,1410543,34717,56532,181264026
0400000US25,25,Massachusetts,,2013,1481,Education - Elementary and Secondary Total ,2185,9693997,77,92871,4776,2214,2262,9786868
0400000US25,25,Massachusetts,,2013,14811,Education - Elementary and Secondary Instructional             ,1745,7836166,1,900,20,1745,1746,7837066
0400000US25,25,Massachusetts,,2013,14812,Education - Elementary and Secondary Other ,440,1857831,76,91971,4756,469,516,1949802
0400000US25,25,Massachusetts,,2013,1482,Education - Higher Education Total ,22989,129422157,30093,35217937,1401049,31384,53082,164640094
0400000US25,25,Massachusetts,,2013,14821,Education - Higher Education Instructional,6698,46683923,12335,22446327,732377,11102,19033,69130250
0400000US25,25,Massachusetts,,2013,14822,Education - Higher Education Other ,16291,82738234,17758,12771610,668672,20282,34049,95509844
0400000US25,25,Massachusetts,,2013,1483,Education - Other,1090,6539190,98,297874,4718,1119,1188,6837064
0400000US25,25,Massachusetts,,2013,1500,Libraries                          ,0,0,0,0,0,0,0,0
0400000US25,25,Massachusetts,,2013,1560,State liquor stores,0,0,0,0,0,0,0,0
0400000US25,25,Massachusetts,,2013,1580,All other and unallocable,4092,24656790,217,856530,17098,4189,4309,25513320
0400000US26,26,Michigan,,2013,1000,Total - All Government Employment Functions,111881,620181874,73042,115427934,5486346,142960,184923,735609808
0400000US26,26,Michigan,,2013,1020,Financial Administration,3837,21176942,390,1708884,58288,4166,4227,22885826
0400000US26,26,Michigan,,2013,1040,Other Government Administration,1461,7025854,33,130900,4732,1488,1494,7156754
0400000US26,26,Michigan,,2013,1060,Judicial and Legal,1380,9498289,54,196888,6266,1416,1434,9695177
0400000US26,26,Michigan,,2013,1100,Police Protection Total,2447,14607282,35,67443,3470,2467,2482,14674725
0400000US26,26,Michigan,,2013,1101,Police Protection - Persons with Power of Arrest       ,1804,11343274,0,0,0,1804,1804,11343274
0400000US26,26,Michigan,,2013,1102,Police Protection - Other ,643,3264008,35,67443,3470,663,678,3331451
0400000US26,26,Michigan,,2013,1120,Fire Protection Total ,0,0,0,0,0,0,0,0
0400000US26,26,Michigan,,2013,1121,Fire Protection - Firefighters,0,0,0,0,0,0,0,0
0400000US26,26,Michigan,,2013,1122,Fire Protection - Other ,0,0,0,0,0,0,0,0
0400000US26,26,Michigan,,2013,1140,Corrections,13097,64208887,198,852713,29399,13263,13295,65061600
0400000US26,26,Michigan,,2013,1160,Highways,2400,12868386,333,1044437,49217,2678,2733,13912823
0400000US26,26,Michigan,,2013,1180,Air Transportation,0,0,0,0,0,0,0,0
0400000US26,26,Michigan,,2013,1200,Water Transport and Terminals       ,0,0,0,0,0,0,0,0
0400000US26,26,Michigan,,2013,1220,Public Welfare,11315,50912505,888,3458400,149775,12161,12203,54370905
0400000US26,26,Michigan,,2013,1240,Health,4514,21531020,939,3685684,112368,5148,5453,25216704
0400000US26,26,Michigan,,2013,1260,Hospitals,11535,60241035,5559,22335656,905468,16651,17094,82576691
0400000US26,26,Michigan,,2013,1280,Social Insurance Administration,879,4436645,62,209748,10401,938,941,4646393
0400000US26,26,Michigan,,2013,1300,Solid Waste Management,0,0,0,0,0,0,0,0
0400000US26,26,Michigan,,2013,1320,Sewerage,0,0,0,0,0,0,0,0
0400000US26,26,Michigan,,2013,1340,Parks and Recreation,155,787207,77,242668,9524,209,232,1029875
0400000US26,26,Michigan,,2013,1360,Housing and Community Development,277,1562307,55,125167,7002,317,332,1687474
0400000US26,26,Michigan,,2013,1380,Natural Resources,3117,15441641,623,1077031,61661,3465,3740,16518672
0400000US26,26,Michigan,,2013,1400,Water Supply,0,0,0,0,0,0,0,0
0400000US26,26,Michigan,,2013,1420,Electric Power,0,0,0,0,0,0,0,0
0400000US26,26,Michigan,,2013,1440,Gas Supply,0,0,0,0,0,0,0,0
0400000US26,26,Michigan,,2013,1460,Transit,0,0,0,0,0,0,0,0
0400000US26,26,Michigan,,2013,1480,Education Total ,51432,315777306,63212,78864529,4006251,74149,114644,394641835
0400000US26,26,Michigan,,2013,1481,Education - Elementary and Secondary Total ,0,0,0,0,0,0,0,0
0400000US26,26,Michigan,,2013,14811,Education - Elementary and Secondary Instructional             ,0,0,0,0,0,0,0,0
0400000US26,26,Michigan,,2013,14812,Education - Elementary and Secondary Other ,0,0,0,0,0,0,0,0
0400000US26,26,Michigan,,2013,1482,Education - Higher Education Total ,50887,312632612,63116,78499123,3990622,73515,114003,391131735
0400000US26,26,Michigan,,2013,14821,Education - Higher Education Instructional,16147,148348674,13264,36498411,1342344,23761,29411,184847085
0400000US26,26,Michigan,,2013,14822,Education - Higher Education Other ,34740,164283938,49852,42000712,2648278,49754,84592,206284650
0400000US26,26,Michigan,,2013,1483,Education - Other,545,3144694,96,365406,15629,634,641,3510100
0400000US26,26,Michigan,,2013,1500,Libraries                          ,0,0,0,0,0,0,0,0
0400000US26,26,Michigan,,2013,1560,State liquor stores,0,0,0,0,0,0,0,0
0400000US26,26,Michigan,,2013,1580,All other and unallocable,4035,20106568,584,1427786,72524,4444,4619,21534354
0400000US27,27,Minnesota,,2013,1000,Total - All Government Employment Functions,66733,365277864,35530,50962037,2476788,80739,102263,416239901
0400000US27,27,Minnesota,,2013,1020,Financial Administration,4680,25962178,147,471351,19905,4793,4827,26433529
0400000US27,27,Minnesota,,2013,1040,Other Government Administration,838,4400541,149,402436,16903,933,987,4802977
0400000US27,27,Minnesota,,2013,1060,Judicial and Legal,3251,18035244,519,2059108,63811,3612,3770,20094352
0400000US27,27,Minnesota,,2013,1100,Police Protection Total,900,4183229,34,74943,3718,921,934,4258172
0400000US27,27,Minnesota,,2013,1101,Police Protection - Persons with Power of Arrest       ,507,2752125,0,0,0,507,507,2752125
0400000US27,27,Minnesota,,2013,1102,Police Protection - Other ,393,1431104,34,74943,3718,414,427,1506047
0400000US27,27,Minnesota,,2013,1120,Fire Protection Total ,0,0,0,0,0,0,0,0
0400000US27,27,Minnesota,,2013,1121,Fire Protection - Firefighters,0,0,0,0,0,0,0,0
0400000US27,27,Minnesota,,2013,1122,Fire Protection - Other ,0,0,0,0,0,0,0,0
0400000US27,27,Minnesota,,2013,1140,Corrections,4005,17367064,144,438309,21443,4126,4149,17805373
0400000US27,27,Minnesota,,2013,1160,Highways,4403,22110692,227,358548,22847,4532,4630,22469240
0400000US27,27,Minnesota,,2013,1180,Air Transportation,0,0,0,0,0,0,0,0
0400000US27,27,Minnesota,,2013,1200,Water Transport and Terminals       ,0,0,0,0,0,0,0,0
0400000US27,27,Minnesota,,2013,1220,Public Welfare,1487,6917761,1366,3444516,240992,2849,2853,10362277
0400000US27,27,Minnesota,,2013,1240,Health,2765,13902980,2173,1500751,59200,3099,4938,15403731
0400000US27,27,Minnesota,,2013,1260,Hospitals,3002,14493625,1408,4195903,221646,4254,4410,18689528
0400000US27,27,Minnesota,,2013,1280,Social Insurance Administration,1045,4540760,74,187161,8111,1091,1119,4727921
0400000US27,27,Minnesota,,2013,1300,Solid Waste Management,0,0,0,0,0,0,0,0
0400000US27,27,Minnesota,,2013,1320,Sewerage,624,3696292,13,31303,1098,630,637,3727595
0400000US27,27,Minnesota,,2013,1340,Parks and Recreation,507,2358484,155,199673,11138,571,662,2558157
0400000US27,27,Minnesota,,2013,1360,Housing and Community Development,0,0,0,0,0,0,0,0
0400000US27,27,Minnesota,,2013,1380,Natural Resources,2578,12639968,615,1240616,73143,2992,3193,13880584
0400000US27,27,Minnesota,,2013,1400,Water Supply,0,0,0,0,0,0,0,0
0400000US27,27,Minnesota,,2013,1420,Electric Power,0,0,0,0,0,0,0,0
0400000US27,27,Minnesota,,2013,1440,Gas Supply,0,0,0,0,0,0,0,0
0400000US27,27,Minnesota,,2013,1460,Transit,2383,12378820,393,1058220,48475,2657,2776,13437040
0400000US27,27,Minnesota,,2013,1480,Education Total ,31295,187818466,27915,34860591,1643463,40589,59210,222679057
0400000US27,27,Minnesota,,2013,1481,Education - Elementary and Secondary Total ,0,0,0,0,0,0,0,0
0400000US27,27,Minnesota,,2013,14811,Education - Elementary and Secondary Instructional             ,0,0,0,0,0,0,0,0
0400000US27,27,Minnesota,,2013,14812,Education - Elementary and Secondary Other ,0,0,0,0,0,0,0,0
0400000US27,27,Minnesota,,2013,1482,Education - Higher Education Total ,27978,169761793,26567,32268002,1537218,36673,54545,202029795
0400000US27,27,Minnesota,,2013,14821,Education - Higher Education Instructional,11496,76008423,10703,17082899,614973,14978,22199,93091322
0400000US27,27,Minnesota,,2013,14822,Education - Higher Education Other ,16482,93753370,15864,15185103,922245,21695,32346,108938473
0400000US27,27,Minnesota,,2013,1483,Education - Other,3317,18056673,1348,2592589,106245,3916,4665,20649262
0400000US27,27,Minnesota,,2013,1500,Libraries                          ,0,0,0,0,0,0,0,0
0400000US27,27,Minnesota,,2013,1560,State liquor stores,0,0,0,0,0,0,0,0
0400000US27,27,Minnesota,,2013,1580,All other and unallocable,2970,14471760,198,438608,20895,3090,3168,14910368
0400000US28,28,Mississippi,,2013,1000,Total - All Government Employment Functions,52511,197980812,13689,13968331,931688,57846,66200,211949143
0400000US28,28,Mississippi,,2013,1020,Financial Administration,1377,5051146,55,118228,6075,1412,1432,5169374
0400000US28,28,Mississippi,,2013,1040,Other Government Administration,542,2254242,8,17389,784,547,550,2271631
0400000US28,28,Mississippi,,2013,1060,Judicial and Legal,743,4490371,8,13125,280,745,751,4503496
0400000US28,28,Mississippi,,2013,1100,Police Protection Total,1235,4171376,3,5833,233,1236,1238,4177209
0400000US28,28,Mississippi,,2013,1101,Police Protection - Persons with Power of Arrest       ,700,2769946,0,0,0,700,700,2769946
0400000US28,28,Mississippi,,2013,1102,Police Protection - Other ,535,1401430,3,5833,233,536,538,1407263
0400000US28,28,Mississippi,,2013,1120,Fire Protection Total ,0,0,0,0,0,0,0,0
0400000US28,28,Mississippi,,2013,1121,Fire Protection - Firefighters,0,0,0,0,0,0,0,0
0400000US28,28,Mississippi,,2013,1122,Fire Protection - Other ,0,0,0,0,0,0,0,0
0400000US28,28,Mississippi,,2013,1140,Corrections,3238,8416891,14,28771,2175,3250,3252,8445662
0400000US28,28,Mississippi,,2013,1160,Highways,3388,9956021,10,18417,1145,3394,3398,9974438
0400000US28,28,Mississippi,,2013,1180,Air Transportation,0,0,0,0,0,0,0,0
0400000US28,28,Mississippi,,2013,1200,Water Transport and Terminals       ,39,193086,1,2000,76,39,40,195086
0400000US28,28,Mississippi,,2013,1220,Public Welfare,3033,10236586,0,0,0,3033,3033,10236586
0400000US28,28,Mississippi,,2013,1240,Health,3311,11082082,81,62441,2867,3327,3392,11144523
0400000US28,28,Mississippi,,2013,1260,Hospitals,11160,37674742,1423,1929103,90118,11669,12583,39603845
0400000US28,28,Mississippi,,2013,1280,Social Insurance Administration,680,2229457,242,571401,41336,914,922,2800858
0400000US28,28,Mississippi,,2013,1300,Solid Waste Management,0,0,0,0,0,0,0,0
0400000US28,28,Mississippi,,2013,1320,Sewerage,0,0,0,0,0,0,0,0
0400000US28,28,Mississippi,,2013,1340,Parks and Recreation,338,825850,59,41543,4577,365,397,867393
0400000US28,28,Mississippi,,2013,1360,Housing and Community Development,0,0,0,0,0,0,0,0
0400000US28,28,Mississippi,,2013,1380,Natural Resources,2790,8949896,768,699052,53577,3094,3558,9648948
0400000US28,28,Mississippi,,2013,1400,Water Supply,52,127257,9,9913,820,57,61,137170
0400000US28,28,Mississippi,,2013,1420,Electric Power,0,0,0,0,0,0,0,0
0400000US28,28,Mississippi,,2013,1440,Gas Supply,0,0,0,0,0,0,0,0
0400000US28,28,Mississippi,,2013,1460,Transit,0,0,0,0,0,0,0,0
0400000US28,28,Mississippi,,2013,1480,Education Total ,17140,80964401,10842,10177411,708345,21210,27982,91141812
0400000US28,28,Mississippi,,2013,1481,Education - Elementary and Secondary Total ,0,0,0,0,0,0,0,0
0400000US28,28,Mississippi,,2013,14811,Education - Elementary and Secondary Instructional             ,0,0,0,0,0,0,0,0
0400000US28,28,Mississippi,,2013,14812,Education - Elementary and Secondary Other ,0,0,0,0,0,0,0,0
0400000US28,28,Mississippi,,2013,1482,Education - Higher Education Total ,15640,76042423,10809,10123964,705479,19694,26449,86166387
0400000US28,28,Mississippi,,2013,14821,Education - Higher Education Instructional,5928,31656742,1533,2097816,101744,6509,7461,33754558
0400000US28,28,Mississippi,,2013,14822,Education - Higher Education Other ,9712,44385681,9276,8026148,603735,13185,18988,52411829
0400000US28,28,Mississippi,,2013,1483,Education - Other,1500,4921978,33,53447,2866,1516,1533,4975425
0400000US28,28,Mississippi,,2013,1500,Libraries                          ,0,0,0,0,0,0,0,0
0400000US28,28,Mississippi,,2013,1560,State liquor stores,117,314202,0,0,0,117,117,314202
0400000US28,28,Mississippi,,2013,1580,All other and unallocable,3328,11043206,166,273704,19280,3437,3494,11316910
0400000US29,29,Missouri,,2013,1000,Total - All Government Employment Functions,77028,287245019,29545,26878539,1711378,86712,106573,314123558
0400000US29,29,Missouri,,2013,1020,Financial Administration,2850,10377320,157,221294,18390,2954,3007,10598614
0400000US29,29,Missouri,,2013,1040,Other Government Administration,660,2386134,300,714350,34664,856,960,3100484
0400000US29,29,Missouri,,2013,1060,Judicial and Legal,3991,15438606,319,449244,34808,4188,4310,15887850
0400000US29,29,Missouri,,2013,1100,Police Protection Total,2378,9593034,133,150402,16578,2472,2511,9743436
0400000US29,29,Missouri,,2013,1101,Police Protection - Persons with Power of Arrest       ,1309,6266458,0,0,0,1309,1309,6266458
0400000US29,29,Missouri,,2013,1102,Police Protection - Other ,1069,3326576,133,150402,16578,1163,1202,3476978
0400000US29,29,Missouri,,2013,1120,Fire Protection Total ,0,0,0,0,0,0,0,0
0400000US29,29,Missouri,,2013,1121,Fire Protection - Firefighters,0,0,0,0,0,0,0,0
0400000US29,29,Missouri,,2013,1122,Fire Protection - Other ,0,0,0,0,0,0,0,0
0400000US29,29,Missouri,,2013,1140,Corrections,12024,31711956,155,150716,11234,12087,12179,31862672
0400000US29,29,Missouri,,2013,1160,Highways,5183,17559804,0,0,0,5183,5183,17559804
0400000US29,29,Missouri,,2013,1180,Air Transportation,0,0,0,0,0,0,0,0
0400000US29,29,Missouri,,2013,1200,Water Transport and Terminals       ,0,0,0,0,0,0,0,0
0400000US29,29,Missouri,,2013,1220,Public Welfare,6882,17900690,298,310030,20404,6998,7180,18210720
0400000US29,29,Missouri,,2013,1240,Health,2668,9630692,213,403944,16427,2761,2881,10034636
0400000US29,29,Missouri,,2013,1260,Hospitals,9940,31455574,1366,1861937,106350,10540,11306,33317511
0400000US29,29,Missouri,,2013,1280,Social Insurance Administration,604,1742942,62,43792,2790,620,666,1786734
0400000US29,29,Missouri,,2013,1300,Solid Waste Management,0,0,0,0,0,0,0,0
0400000US29,29,Missouri,,2013,1320,Sewerage,0,0,0,0,0,0,0,0
0400000US29,29,Missouri,,2013,1340,Parks and Recreation,483,1468510,490,56379,6969,522,973,1524889
0400000US29,29,Missouri,,2013,1360,Housing and Community Development,0,0,0,0,0,0,0,0
0400000US29,29,Missouri,,2013,1380,Natural Resources,1934,6914008,486,480802,48980,2211,2420,7394810
0400000US29,29,Missouri,,2013,1400,Water Supply,0,0,0,0,0,0,0,0
0400000US29,29,Missouri,,2013,1420,Electric Power,0,0,0,0,0,0,0,0
0400000US29,29,Missouri,,2013,1440,Gas Supply,0,0,0,0,0,0,0,0
0400000US29,29,Missouri,,2013,1460,Transit,0,0,0,0,0,0,0,0
0400000US29,29,Missouri,,2013,1480,Education Total ,23661,117940141,25314,21690718,1371818,31425,48975,139630859
0400000US29,29,Missouri,,2013,1481,Education - Elementary and Secondary Total ,0,0,0,0,0,0,0,0
0400000US29,29,Missouri,,2013,14811,Education - Elementary and Secondary Instructional             ,0,0,0,0,0,0,0,0
0400000US29,29,Missouri,,2013,14812,Education - Elementary and Secondary Other ,0,0,0,0,0,0,0,0
0400000US29,29,Missouri,,2013,1482,Education - Higher Education Total ,22640,114345757,24341,19929398,1263604,29793,46981,134275155
0400000US29,29,Missouri,,2013,14821,Education - Higher Education Instructional,8338,56600638,8297,10535056,499152,11161,16635,67135694
0400000US29,29,Missouri,,2013,14822,Education - Higher Education Other ,14302,57745119,16044,9394342,764452,18632,30346,67139461
0400000US29,29,Missouri,,2013,1483,Education - Other,1021,3594384,973,1761320,108214,1632,1994,5355704
0400000US29,29,Missouri,,2013,1500,Libraries                          ,0,0,0,0,0,0,0,0
0400000US29,29,Missouri,,2013,1560,State liquor stores,0,0,0,0,0,0,0,0
0400000US29,29,Missouri,,2013,1580,All other and unallocable,3770,13125608,252,344931,21966,3895,4022,13470539
0400000US30,30,Montana,,2013,1000,Total - All Government Employment Functions,16260,70306328,10847,13574323,803074,20799,27107,83880651
0400000US30,30,Montana,,2013,1020,Financial Administration,969,3781048,83,150310,8895,1020,1052,3931358
0400000US30,30,Montana,,2013,1040,Other Government Administration,572,2284112,142,199492,13995,651,714,2483604
0400000US30,30,Montana,,2013,1060,Judicial and Legal,662,2952190,93,170839,8334,710,755,3123029
0400000US30,30,Montana,,2013,1100,Police Protection Total,446,2036155,34,102517,3867,469,480,2138672
0400000US30,30,Montana,,2013,1101,Police Protection - Persons with Power of Arrest       ,204,1051967,12,58196,1659,213,216,1110163
0400000US30,30,Montana,,2013,1102,Police Protection - Other ,242,984188,22,44321,2208,256,264,1028509
0400000US30,30,Montana,,2013,1120,Fire Protection Total ,0,0,0,0,0,0,0,0
0400000US30,30,Montana,,2013,1121,Fire Protection - Firefighters,0,0,0,0,0,0,0,0
0400000US30,30,Montana,,2013,1122,Fire Protection - Other ,0,0,0,0,0,0,0,0
0400000US30,30,Montana,,2013,1140,Corrections,1263,5331159,15,42324,1995,1274,1278,5373483
0400000US30,30,Montana,,2013,1160,Highways,2009,8877862,179,307726,16468,2102,2188,9185588
0400000US30,30,Montana,,2013,1180,Air Transportation,0,0,0,0,0,0,0,0
0400000US30,30,Montana,,2013,1200,Water Transport and Terminals       ,0,0,0,0,0,0,0,0
0400000US30,30,Montana,,2013,1220,Public Welfare,1182,4456505,575,1754894,93259,1709,1757,6211399
0400000US30,30,Montana,,2013,1240,Health,754,3072549,261,603880,28713,917,1015,3676429
0400000US30,30,Montana,,2013,1260,Hospitals,494,1847447,236,414404,24804,634,730,2261851
0400000US30,30,Montana,,2013,1280,Social Insurance Administration,609,2687067,126,363505,19889,721,735,3050572
0400000US30,30,Montana,,2013,1300,Solid Waste Management,0,0,0,0,0,0,0,0
0400000US30,30,Montana,,2013,1320,Sewerage,0,0,0,0,0,0,0,0
0400000US30,30,Montana,,2013,1340,Parks and Recreation,40,162219,56,115482,5509,71,96,277701
0400000US30,30,Montana,,2013,1360,Housing and Community Development,0,0,0,0,0,0,0,0
0400000US30,30,Montana,,2013,1380,Natural Resources,1267,5190307,496,1034044,53806,1570,1763,6224351
0400000US30,30,Montana,,2013,1400,Water Supply,0,0,0,0,0,0,0,0
0400000US30,30,Montana,,2013,1420,Electric Power,0,0,0,0,0,0,0,0
0400000US30,30,Montana,,2013,1440,Gas Supply,0,0,0,0,0,0,0,0
0400000US30,30,Montana,,2013,1460,Transit,0,0,0,0,0,0,0,0
0400000US30,30,Montana,,2013,1480,Education Total ,4883,22764384,8399,7947784,505620,7739,13282,30712168
0400000US30,30,Montana,,2013,1481,Education - Elementary and Secondary Total ,0,0,0,0,0,0,0,0
0400000US30,30,Montana,,2013,14811,Education - Elementary and Secondary Instructional             ,0,0,0,0,0,0,0,0
0400000US30,30,Montana,,2013,14812,Education - Elementary and Secondary Other ,0,0,0,0,0,0,0,0
0400000US30,30,Montana,,2013,1482,Education - Higher Education Total ,4581,21457243,8255,7694806,491777,7359,12836,29152049
0400000US30,30,Montana,,2013,14821,Education - Higher Education Instructional,1362,8957310,1598,2583593,118253,2030,2960,11540903
0400000US30,30,Montana,,2013,14822,Education - Higher Education Other ,3219,12499933,6657,5111213,373524,5329,9876,17611146
0400000US30,30,Montana,,2013,1483,Education - Other,302,1307141,144,252978,13843,380,446,1560119
0400000US30,30,Montana,,2013,1500,Libraries                          ,0,0,0,0,0,0,0,0
0400000US30,30,Montana,,2013,1560,State liquor stores,27,101545,4,7137,445,30,31,108682
0400000US30,30,Montana,,2013,1580,All other and unallocable,1083,4761779,148,359985,17475,1182,1231,5121764
0400000US31,31,Nebraska,,2013,1000,Total - All Government Employment Functions,26607,110554792,10361,11860171,950029,31976,36968,122414963
0400000US31,31,Nebraska,,2013,1020,Financial Administration,789,3068996,15,23298,1211,796,804,3092294
0400000US31,31,Nebraska,,2013,1040,Other Government Administration,270,1023983,100,111166,6195,305,370,1135149
0400000US31,31,Nebraska,,2013,1060,Judicial and Legal,725,3548123,45,43521,2784,741,770,3591644
0400000US31,31,Nebraska,,2013,1100,Police Protection Total,768,3546418,9,13967,1021,774,777,3560385
0400000US31,31,Nebraska,,2013,1101,Police Protection - Persons with Power of Arrest       ,467,2491730,0,0,0,467,467,2491730
0400000US31,31,Nebraska,,2013,1102,Police Protection - Other ,301,1054688,9,13967,1021,307,310,1068655
0400000US31,31,Nebraska,,2013,1120,Fire Protection Total ,0,0,0,0,0,0,0,0
0400000US31,31,Nebraska,,2013,1121,Fire Protection - Firefighters,0,0,0,0,0,0,0,0
0400000US31,31,Nebraska,,2013,1122,Fire Protection - Other ,0,0,0,0,0,0,0,0
0400000US31,31,Nebraska,,2013,1140,Corrections,2826,9807476,75,99739,6449,2862,2901,9907215
0400000US31,31,Nebraska,,2013,1160,Highways,2074,8159045,7,19922,795,2078,2081,8178967
0400000US31,31,Nebraska,,2013,1180,Air Transportation,22,97220,0,0,0,22,22,97220
0400000US31,31,Nebraska,,2013,1200,Water Transport and Terminals       ,0,0,0,0,0,0,0,0
0400000US31,31,Nebraska,,2013,1220,Public Welfare,2267,6854370,235,316999,19971,2380,2502,7171369
0400000US31,31,Nebraska,,2013,1240,Health,634,2618861,16,25706,1709,644,650,2644567
0400000US31,31,Nebraska,,2013,1260,Hospitals,3169,12194326,747,1836037,114064,3813,3916,14030363
0400000US31,31,Nebraska,,2013,1280,Social Insurance Administration,208,747656,5,7783,468,211,213,755439
0400000US31,31,Nebraska,,2013,1300,Solid Waste Management,0,0,0,0,0,0,0,0
0400000US31,31,Nebraska,,2013,1320,Sewerage,0,0,0,0,0,0,0,0
0400000US31,31,Nebraska,,2013,1340,Parks and Recreation,202,702154,160,130431,13400,278,362,832585
0400000US31,31,Nebraska,,2013,1360,Housing and Community Development,0,0,0,0,0,0,0,0
0400000US31,31,Nebraska,,2013,1380,Natural Resources,1520,5754154,746,1607220,110144,2142,2266,7361374
0400000US31,31,Nebraska,,2013,1400,Water Supply,0,0,0,0,0,0,0,0
0400000US31,31,Nebraska,,2013,1420,Electric Power,0,0,0,0,0,0,0,0
0400000US31,31,Nebraska,,2013,1440,Gas Supply,0,0,0,0,0,0,0,0
0400000US31,31,Nebraska,,2013,1460,Transit,0,0,0,0,0,0,0,0
0400000US31,31,Nebraska,,2013,1480,Education Total ,9277,45130914,8006,7477120,663484,13026,17283,52608034
0400000US31,31,Nebraska,,2013,1481,Education - Elementary and Secondary Total ,0,0,0,0,0,0,0,0
0400000US31,31,Nebraska,,2013,14811,Education - Elementary and Secondary Instructional             ,0,0,0,0,0,0,0,0
0400000US31,31,Nebraska,,2013,14812,Education - Elementary and Secondary Other ,0,0,0,0,0,0,0,0
0400000US31,31,Nebraska,,2013,1482,Education - Higher Education Total ,8761,42898713,7980,7429232,660958,12496,16741,50327945
0400000US31,31,Nebraska,,2013,14821,Education - Higher Education Instructional,2771,19641906,1132,2128383,98784,3329,3903,21770289
0400000US31,31,Nebraska,,2013,14822,Education - Higher Education Other ,5990,23256807,6848,5300849,562174,9167,12838,28557656
0400000US31,31,Nebraska,,2013,1483,Education - Other,516,2232201,26,47888,2526,530,542,2280089
0400000US31,31,Nebraska,,2013,1500,Libraries                          ,0,0,0,0,0,0,0,0
0400000US31,31,Nebraska,,2013,1560,State liquor stores,0,0,0,0,0,0,0,0
0400000US31,31,Nebraska,,2013,1580,All other and unallocable,1856,7301096,195,147262,8334,1904,2051,7448358
0400000US32,32,Nevada,,2013,1000,Total - All Government Employment Functions,24387,116338425,10038,11811016,504380,27233,34425,128149441
0400000US32,32,Nevada,,2013,1020,Financial Administration,1355,5017089,10,21638,602,1358,1365,5038727
0400000US32,32,Nevada,,2013,1040,Other Government Administration,1252,6222722,26,57064,2636,1266,1278,6279786
0400000US32,32,Nevada,,2013,1060,Judicial and Legal,739,4704102,11,21733,432,741,750,4725835
0400000US32,32,Nevada,,2013,1100,Police Protection Total,887,5747689,3,6816,270,888,890,5754505
0400000US32,32,Nevada,,2013,1101,Police Protection - Persons with Power of Arrest       ,473,3991932,1,1845,84,473,474,3993777
0400000US32,32,Nevada,,2013,1102,Police Protection - Other ,414,1755757,2,4971,186,415,416,1760728
0400000US32,32,Nevada,,2013,1120,Fire Protection Total ,0,0,0,0,0,0,0,0
0400000US32,32,Nevada,,2013,1121,Fire Protection - Firefighters,0,0,0,0,0,0,0,0
0400000US32,32,Nevada,,2013,1122,Fire Protection - Other ,0,0,0,0,0,0,0,0
0400000US32,32,Nevada,,2013,1140,Corrections,3567,14780012,51,151966,2287,3580,3618,14931978
0400000US32,32,Nevada,,2013,1160,Highways,1732,7366851,5,10343,370,1734,1737,7377194
0400000US32,32,Nevada,,2013,1180,Air Transportation,0,0,0,0,0,0,0,0
0400000US32,32,Nevada,,2013,1200,Water Transport and Terminals       ,0,0,0,0,0,0,0,0
0400000US32,32,Nevada,,2013,1220,Public Welfare,1823,6408060,10,14838,487,1826,1833,6422898
0400000US32,32,Nevada,,2013,1240,Health,1336,5794660,26,79847,1588,1345,1362,5874507
0400000US32,32,Nevada,,2013,1260,Hospitals,1277,5663817,50,150118,3065,1294,1327,5813935
0400000US32,32,Nevada,,2013,1280,Social Insurance Administration,635,2145413,0,0,0,635,635,2145413
0400000US32,32,Nevada,,2013,1300,Solid Waste Management,0,0,0,0,0,0,0,0
0400000US32,32,Nevada,,2013,1320,Sewerage,0,0,0,0,0,0,0,0
0400000US32,32,Nevada,,2013,1340,Parks and Recreation,113,437256,58,169845,6145,148,171,607101
0400000US32,32,Nevada,,2013,1360,Housing and Community Development,0,0,0,0,0,0,0,0
0400000US32,32,Nevada,,2013,1380,Natural Resources,810,3731544,108,146756,7828,854,918,3878300
0400000US32,32,Nevada,,2013,1400,Water Supply,19,105103,0,0,0,19,19,105103
0400000US32,32,Nevada,,2013,1420,Electric Power,19,105103,0,0,0,19,19,105103
0400000US32,32,Nevada,,2013,1440,Gas Supply,0,0,0,0,0,0,0,0
0400000US32,32,Nevada,,2013,1460,Transit,0,0,0,0,0,0,0,0
0400000US32,32,Nevada,,2013,1480,Education Total ,6807,38756449,9594,10843245,473228,9481,16401,49599694
0400000US32,32,Nevada,,2013,1481,Education - Elementary and Secondary Total ,0,0,0,0,0,0,0,0
0400000US32,32,Nevada,,2013,14811,Education - Elementary and Secondary Instructional             ,0,0,0,0,0,0,0,0
0400000US32,32,Nevada,,2013,14812,Education - Elementary and Secondary Other ,0,0,0,0,0,0,0,0
0400000US32,32,Nevada,,2013,1482,Education - Higher Education Total ,6673,38116294,9592,10839197,473137,9346,16265,48955491
0400000US32,32,Nevada,,2013,14821,Education - Higher Education Instructional,1928,16028490,4193,6141183,219465,3168,6121,22169673
0400000US32,32,Nevada,,2013,14822,Education - Higher Education Other ,4745,22087804,5399,4698014,253672,6178,10144,26785818
0400000US32,32,Nevada,,2013,1483,Education - Other,134,640155,2,4048,91,135,136,644203
0400000US32,32,Nevada,,2013,1500,Libraries                          ,0,0,0,0,0,0,0,0
0400000US32,32,Nevada,,2013,1560,State liquor stores,0,0,0,0,0,0,0,0
0400000US32,32,Nevada,,2013,1580,All other and unallocable,2016,9352555,86,136807,5442,2045,2102,9489362
0400000US33,33,New Hampshire,,2013,1000,Total - All Government Employment Functions,14693,70965305,11012,12911913,640917,18556,25705,83877218
0400000US33,33,New Hampshire,,2013,1020,Financial Administration,722,3340673,58,72216,4707,749,780,3412889
0400000US33,33,New Hampshire,,2013,1040,Other Government Administration,304,1341845,475,288092,16415,403,779,1629937
0400000US33,33,New Hampshire,,2013,1060,Judicial and Legal,640,3113816,262,808316,19349,756,902,3922132
0400000US33,33,New Hampshire,,2013,1100,Police Protection Total,474,2485693,40,52448,2744,491,514,2538141
0400000US33,33,New Hampshire,,2013,1101,Police Protection - Persons with Power of Arrest       ,317,1864269,0,0,0,317,317,1864269
0400000US33,33,New Hampshire,,2013,1102,Police Protection - Other ,157,621424,40,52448,2744,174,197,673872
0400000US33,33,New Hampshire,,2013,1120,Fire Protection Total ,0,0,0,0,0,0,0,0
0400000US33,33,New Hampshire,,2013,1121,Fire Protection - Firefighters,0,0,0,0,0,0,0,0
0400000US33,33,New Hampshire,,2013,1122,Fire Protection - Other ,0,0,0,0,0,0,0,0
0400000US33,33,New Hampshire,,2013,1140,Corrections,1050,4891405,93,174878,12296,1124,1143,5066283
0400000US33,33,New Hampshire,,2013,1160,Highways,1557,6671632,173,250682,15664,1651,1730,6922314
0400000US33,33,New Hampshire,,2013,1180,Air Transportation,27,127829,19,43573,2779,43,46,171402
0400000US33,33,New Hampshire,,2013,1200,Water Transport and Terminals       ,8,44317,8,7072,560,11,16,51389
0400000US33,33,New Hampshire,,2013,1220,Public Welfare,1811,7266874,150,264905,16780,1912,1961,7531779
0400000US33,33,New Hampshire,,2013,1240,Health,774,3662248,55,76947,3897,798,829,3739195
0400000US33,33,New Hampshire,,2013,1260,Hospitals,524,2154113,79,113376,8215,573,603,2267489
0400000US33,33,New Hampshire,,2013,1280,Social Insurance Administration,272,1028345,48,84513,5157,303,320,1112858
0400000US33,33,New Hampshire,,2013,1300,Solid Waste Management,0,0,0,0,0,0,0,0
0400000US33,33,New Hampshire,,2013,1320,Sewerage,0,0,0,0,0,0,0,0
0400000US33,33,New Hampshire,,2013,1340,Parks and Recreation,148,559573,313,276870,22916,286,461,836443
0400000US33,33,New Hampshire,,2013,1360,Housing and Community Development,0,0,0,0,0,0,0,0
0400000US33,33,New Hampshire,,2013,1380,Natural Resources,328,1523159,58,74373,3826,352,386,1597532
0400000US33,33,New Hampshire,,2013,1400,Water Supply,21,94864,5,9840,487,24,26,104704
0400000US33,33,New Hampshire,,2013,1420,Electric Power,0,0,0,0,0,0,0,0
0400000US33,33,New Hampshire,,2013,1440,Gas Supply,0,0,0,0,0,0,0,0
0400000US33,33,New Hampshire,,2013,1460,Transit,0,0,0,0,0,0,0,0
0400000US33,33,New Hampshire,,2013,1480,Education Total ,4487,26002470,8101,9290919,429214,7077,12588,35293389
0400000US33,33,New Hampshire,,2013,1481,Education - Elementary and Secondary Total ,0,0,0,0,0,0,0,0
0400000US33,33,New Hampshire,,2013,14811,Education - Elementary and Secondary Instructional             ,0,0,0,0,0,0,0,0
0400000US33,33,New Hampshire,,2013,14812,Education - Elementary and Secondary Other ,0,0,0,0,0,0,0,0
0400000US33,33,New Hampshire,,2013,1482,Education - Higher Education Total ,4193,24726643,8075,9242424,426663,6768,12268,33969067
0400000US33,33,New Hampshire,,2013,14821,Education - Higher Education Instructional,1461,11355510,2192,4625479,140477,2310,3653,15980989
0400000US33,33,New Hampshire,,2013,14822,Education - Higher Education Other ,2732,13371133,5883,4616945,286186,4458,8615,17988078
0400000US33,33,New Hampshire,,2013,1483,Education - Other,294,1275827,26,48495,2551,309,320,1324322
0400000US33,33,New Hampshire,,2013,1500,Libraries                          ,0,0,0,0,0,0,0,0
0400000US33,33,New Hampshire,,2013,1560,State liquor stores,292,1105272,609,538162,45504,566,901,1643434
0400000US33,33,New Hampshire,,2013,1580,All other and unallocable,1254,5551177,466,484731,30407,1437,1720,6035908
0400000US34,34,New Jersey,,2013,1000,Total - All Government Employment Functions,131805,804951481,30169,47985232,2016078,144475,161974,852936713
0400000US34,34,New Jersey,,2013,1020,Financial Administration,5302,27889710,363,739100,36135,5535,5665,28628810
0400000US34,34,New Jersey,,2013,1040,Other Government Administration,1148,7075943,47,81830,4207,1175,1195,7157773
0400000US34,34,New Jersey,,2013,1060,Judicial and Legal,12891,81011346,221,385352,17500,13004,13112,81396698
0400000US34,34,New Jersey,,2013,1100,Police Protection Total,3742,28677733,50,123776,4105,3768,3792,28801509
0400000US34,34,New Jersey,,2013,1101,Police Protection - Persons with Power of Arrest       ,2498,22372131,0,0,0,2498,2498,22372131
0400000US34,34,New Jersey,,2013,1102,Police Protection - Other ,1244,6305602,50,123776,4105,1270,1294,6429378
0400000US34,34,New Jersey,,2013,1120,Fire Protection Total ,0,0,0,0,0,0,0,0
0400000US34,34,New Jersey,,2013,1121,Fire Protection - Firefighters,0,0,0,0,0,0,0,0
0400000US34,34,New Jersey,,2013,1122,Fire Protection - Other ,0,0,0,0,0,0,0,0
0400000US34,34,New Jersey,,2013,1140,Corrections,9013,54035558,17,47552,1526,9023,9030,54083110
0400000US34,34,New Jersey,,2013,1160,Highways,5629,33555888,528,756252,40601,5860,6157,34312140
0400000US34,34,New Jersey,,2013,1180,Air Transportation,0,0,0,0,0,0,0,0
0400000US34,34,New Jersey,,2013,1200,Water Transport and Terminals       ,85,428376,3,5558,354,87,88,433934
0400000US34,34,New Jersey,,2013,1220,Public Welfare,8766,49358479,185,317280,14440,8859,8951,49675759
0400000US34,34,New Jersey,,2013,1240,Health,3828,22714041,741,2108166,32661,4039,4569,24822207
0400000US34,34,New Jersey,,2013,1260,Hospitals,15853,75282652,2285,4507484,213893,17233,18138,79790136
0400000US34,34,New Jersey,,2013,1280,Social Insurance Administration,1537,7881867,241,758346,34860,1762,1778,8640213
0400000US34,34,New Jersey,,2013,1300,Solid Waste Management,493,3558685,16,21146,1433,502,509,3579831
0400000US34,34,New Jersey,,2013,1320,Sewerage,0,0,0,0,0,0,0,0
0400000US34,34,New Jersey,,2013,1340,Parks and Recreation,853,4479725,486,482807,26025,1012,1339,4962532
0400000US34,34,New Jersey,,2013,1360,Housing and Community Development,0,0,0,0,0,0,0,0
0400000US34,34,New Jersey,,2013,1380,Natural Resources,1780,10897862,338,533269,24487,1932,2118,11431131
0400000US34,34,New Jersey,,2013,1400,Water Supply,110,605158,0,0,0,110,110,605158
0400000US34,34,New Jersey,,2013,1420,Electric Power,0,0,0,0,0,0,0,0
0400000US34,34,New Jersey,,2013,1440,Gas Supply,0,0,0,0,0,0,0,0
0400000US34,34,New Jersey,,2013,1460,Transit,10713,61532084,792,1267630,64477,11077,11505,62799714
0400000US34,34,New Jersey,,2013,1480,Education Total ,44356,300123965,23688,35530552,1484608,53696,68044,335654517
0400000US34,34,New Jersey,,2013,1481,Education - Elementary and Secondary Total ,14650,97006015,3051,5063289,157600,15689,17701,102069304
0400000US34,34,New Jersey,,2013,14811,Education - Elementary and Secondary Instructional             ,10112,78205192,814,1759758,50046,10454,10926,79964950
0400000US34,34,New Jersey,,2013,14812,Education - Elementary and Secondary Other ,4538,18800823,2237,3303531,107554,5235,6775,22104354
0400000US34,34,New Jersey,,2013,1482,Education - Higher Education Total ,27300,188328879,20236,29681771,1299099,35421,47536,218010650
0400000US34,34,New Jersey,,2013,14821,Education - Higher Education Instructional,7791,83996703,6398,13089196,285313,9605,14189,97085899
0400000US34,34,New Jersey,,2013,14822,Education - Higher Education Other ,19509,104332176,13838,16592575,1013786,25816,33347,120924751
0400000US34,34,New Jersey,,2013,1483,Education - Other,2406,14789071,401,785492,27909,2586,2807,15574563
0400000US34,34,New Jersey,,2013,1500,Libraries                          ,0,0,0,0,0,0,0,0
0400000US34,34,New Jersey,,2013,1560,State liquor stores,0,0,0,0,0,0,0,0
0400000US34,34,New Jersey,,2013,1580,All other and unallocable,5706,35842409,168,319132,14766,5801,5874,36161541
0400000US35,35,New Mexico,,2013,1000,Total - All Government Employment Functions,39038,177048620,14664,18277158,977937,44666,53702,195325778
0400000US35,35,New Mexico,,2013,1020,Financial Administration,1061,4502121,9,25717,1313,1069,1070,4527838
0400000US35,35,New Mexico,,2013,1040,Other Government Administration,185,986085,16,23088,1414,194,201,1009173
0400000US35,35,New Mexico,,2013,1060,Judicial and Legal,3008,12146208,65,89404,5956,3044,3073,12235612
0400000US35,35,New Mexico,,2013,1100,Police Protection Total,505,2117840,0,0,0,505,505,2117840
0400000US35,35,New Mexico,,2013,1101,Police Protection - Persons with Power of Arrest       ,505,2117840,0,0,0,505,505,2117840
0400000US35,35,New Mexico,,2013,1102,Police Protection - Other ,0,0,0,0,0,0,0,0
0400000US35,35,New Mexico,,2013,1120,Fire Protection Total ,0,0,0,0,0,0,0,0
0400000US35,35,New Mexico,,2013,1121,Fire Protection - Firefighters,0,0,0,0,0,0,0,0
0400000US35,35,New Mexico,,2013,1122,Fire Protection - Other ,0,0,0,0,0,0,0,0
0400000US35,35,New Mexico,,2013,1140,Corrections,3618,12139207,34,78353,4396,3643,3652,12217560
0400000US35,35,New Mexico,,2013,1160,Highways,2059,7287292,0,0,0,2059,2059,7287292
0400000US35,35,New Mexico,,2013,1180,Air Transportation,3,13824,0,0,0,3,3,13824
0400000US35,35,New Mexico,,2013,1200,Water Transport and Terminals       ,0,0,0,0,0,0,0,0
0400000US35,35,New Mexico,,2013,1220,Public Welfare,1714,5920533,5,12752,797,1719,1719,5933285
0400000US35,35,New Mexico,,2013,1240,Health,2254,8941837,68,208620,11424,2319,2322,9150457
0400000US35,35,New Mexico,,2013,1260,Hospitals,6709,28728893,932,2418853,130478,7541,7641,31147746
0400000US35,35,New Mexico,,2013,1280,Social Insurance Administration,495,1606336,1,2159,113,496,496,1608495
0400000US35,35,New Mexico,,2013,1300,Solid Waste Management,0,0,0,0,0,0,0,0
0400000US35,35,New Mexico,,2013,1320,Sewerage,0,0,0,0,0,0,0,0
0400000US35,35,New Mexico,,2013,1340,Parks and Recreation,592,2006109,30,55231,4411,617,622,2061340
0400000US35,35,New Mexico,,2013,1360,Housing and Community Development,0,0,0,0,0,0,0,0
0400000US35,35,New Mexico,,2013,1380,Natural Resources,940,3962508,68,70321,4468,966,1008,4032829
0400000US35,35,New Mexico,,2013,1400,Water Supply,0,0,0,0,0,0,0,0
0400000US35,35,New Mexico,,2013,1420,Electric Power,0,0,0,0,0,0,0,0
0400000US35,35,New Mexico,,2013,1440,Gas Supply,0,0,0,0,0,0,0,0
0400000US35,35,New Mexico,,2013,1460,Transit,0,0,0,0,0,0,0,0
0400000US35,35,New Mexico,,2013,1480,Education Total ,13818,78601733,13427,15277290,812275,18409,27245,93879023
0400000US35,35,New Mexico,,2013,1481,Education - Elementary and Secondary Total ,0,0,0,0,0,0,0,0
0400000US35,35,New Mexico,,2013,14811,Education - Elementary and Secondary Instructional             ,0,0,0,0,0,0,0,0
0400000US35,35,New Mexico,,2013,14812,Education - Elementary and Secondary Other ,0,0,0,0,0,0,0,0
0400000US35,35,New Mexico,,2013,1482,Education - Higher Education Total ,12977,75262429,13372,15212160,807247,17539,26349,90474589
0400000US35,35,New Mexico,,2013,14821,Education - Higher Education Instructional,3842,31136902,3805,6703496,206935,5011,7647,37840398
0400000US35,35,New Mexico,,2013,14822,Education - Higher Education Other ,9135,44125527,9567,8508664,600312,12528,18702,52634191
0400000US35,35,New Mexico,,2013,1483,Education - Other,841,3339304,55,65130,5028,870,896,3404434
0400000US35,35,New Mexico,,2013,1500,Libraries                          ,0,0,0,0,0,0,0,0
0400000US35,35,New Mexico,,2013,1560,State liquor stores,0,0,0,0,0,0,0,0
0400000US35,35,New Mexico,,2013,1580,All other and unallocable,2077,8088094,9,15370,892,2082,2086,8103464
0400000US36,36,New York,,2013,1000,Total - All Government Employment Functions,222871,1328639883,48595,73662644,2770495,239452,271466,1402302527
0400000US36,36,New York,,2013,1020,Financial Administration,15951,88153313,170,417869,14584,16034,16121,88571182
0400000US36,36,New York,,2013,1040,Other Government Administration,3928,17023647,530,654653,37365,4139,4458,17678300
0400000US36,36,New York,,2013,1060,Judicial and Legal,18424,133071864,531,2037850,66629,18801,18955,135109714
0400000US36,36,New York,,2013,1100,Police Protection Total,5685,49797379,121,182906,17223,5782,5806,49980285
0400000US36,36,New York,,2013,1101,Police Protection - Persons with Power of Arrest       ,4574,44890617,0,0,0,4574,4574,44890617
0400000US36,36,New York,,2013,1102,Police Protection - Other ,1111,4906762,121,182906,17223,1208,1232,5089668
0400000US36,36,New York,,2013,1120,Fire Protection Total ,0,0,0,0,0,0,0,0
0400000US36,36,New York,,2013,1121,Fire Protection - Firefighters,0,0,0,0,0,0,0,0
0400000US36,36,New York,,2013,1122,Fire Protection - Other ,0,0,0,0,0,0,0,0
0400000US36,36,New York,,2013,1140,Corrections,29404,174660572,301,989593,31375,29582,29705,175650165
0400000US36,36,New York,,2013,1160,Highways,10601,59452969,1026,1432590,85245,11084,11627,60885559
0400000US36,36,New York,,2013,1180,Air Transportation,183,839659,2,5367,199,184,185,845026
0400000US36,36,New York,,2013,1200,Water Transport and Terminals       ,542,3217815,33,68813,3215,560,575,3286628
0400000US36,36,New York,,2013,1220,Public Welfare,4061,20365220,508,1310496,61956,4411,4569,21675716
0400000US36,36,New York,,2013,1240,Health,7843,46001715,285,1080028,30830,8019,8128,47081743
0400000US36,36,New York,,2013,1260,Hospitals,39810,214840301,4812,16393605,539204,42889,44622,231233906
0400000US36,36,New York,,2013,1280,Social Insurance Administration,8145,41453811,49,149292,6204,8180,8194,41603103
0400000US36,36,New York,,2013,1300,Solid Waste Management,0,0,0,0,0,0,0,0
0400000US36,36,New York,,2013,1320,Sewerage,0,0,0,0,0,0,0,0
0400000US36,36,New York,,2013,1340,Parks and Recreation,2617,10196123,9,23855,1523,2626,2626,10219978
0400000US36,36,New York,,2013,1360,Housing and Community Development,0,0,0,0,0,0,0,0
0400000US36,36,New York,,2013,1380,Natural Resources,2898,15734032,58,73967,2592,2912,2956,15807999
0400000US36,36,New York,,2013,1400,Water Supply,0,0,0,0,0,0,0,0
0400000US36,36,New York,,2013,1420,Electric Power,1705,13530977,27,88246,2500,1719,1732,13619223
0400000US36,36,New York,,2013,1440,Gas Supply,0,0,0,0,0,0,0,0
0400000US36,36,New York,,2013,1460,Transit,14586,108330346,115,203002,11864,14653,14701,108533348
0400000US36,36,New York,,2013,1480,Education Total ,47140,278420108,39642,47439514,1827948,58349,86782,325859622
0400000US36,36,New York,,2013,1481,Education - Elementary and Secondary Total ,0,0,0,0,0,0,0,0
0400000US36,36,New York,,2013,14811,Education - Elementary and Secondary Instructional             ,0,0,0,0,0,0,0,0
0400000US36,36,New York,,2013,14812,Education - Elementary and Secondary Other ,0,0,0,0,0,0,0,0
0400000US36,36,New York,,2013,1482,Education - Higher Education Total ,42568,256913598,39514,47135384,1815645,53707,82082,304048982
0400000US36,36,New York,,2013,14821,Education - Higher Education Instructional,15233,118791372,19467,28682928,787128,20072,34700,147474300
0400000US36,36,New York,,2013,14822,Education - Higher Education Other ,27335,138122226,20047,18452456,1028517,33635,47382,156574682
0400000US36,36,New York,,2013,1483,Education - Other,4572,21506510,128,304130,12303,4642,4700,21810640
0400000US36,36,New York,,2013,1500,Libraries                          ,0,0,0,0,0,0,0,0
0400000US36,36,New York,,2013,1560,State liquor stores,0,0,0,0,0,0,0,0
0400000US36,36,New York,,2013,1580,All other and unallocable,9348,53550032,376,1110998,30039,9528,9724,54661030
0400000US37,37,North Carolina,,2013,1000,Total - All Government Employment Functions,126575,561663522,44790,61732038,3335126,145421,171365,623395560
0400000US37,37,North Carolina,,2013,1020,Financial Administration,3864,16582957,102,39650,1030,3870,3966,16622607
0400000US37,37,North Carolina,,2013,1040,Other Government Administration,713,3856945,393,885958,47026,979,1106,4742903
0400000US37,37,North Carolina,,2013,1060,Judicial and Legal,6272,29652122,467,336721,3824,6293,6739,29988843
0400000US37,37,North Carolina,,2013,1100,Police Protection Total,3495,15324451,10,21104,703,3499,3505,15345555
0400000US37,37,North Carolina,,2013,1101,Police Protection - Persons with Power of Arrest       ,2511,11759053,0,0,0,2511,2511,11759053
0400000US37,37,North Carolina,,2013,1102,Police Protection - Other ,984,3565398,10,21104,703,988,994,3586502
0400000US37,37,North Carolina,,2013,1120,Fire Protection Total ,0,0,0,0,0,0,0,0
0400000US37,37,North Carolina,,2013,1121,Fire Protection - Firefighters,0,0,0,0,0,0,0,0
0400000US37,37,North Carolina,,2013,1122,Fire Protection - Other ,0,0,0,0,0,0,0,0
0400000US37,37,North Carolina,,2013,1140,Corrections,20736,63561131,193,116047,1479,20744,20929,63677178
0400000US37,37,North Carolina,,2013,1160,Highways,10802,41445991,29,42657,4631,10828,10831,41488648
0400000US37,37,North Carolina,,2013,1180,Air Transportation,0,0,0,0,0,0,0,0
0400000US37,37,North Carolina,,2013,1200,Water Transport and Terminals       ,225,963050,3,5379,319,227,228,968429
0400000US37,37,North Carolina,,2013,1220,Public Welfare,1111,4016175,37,58539,2047,1123,1148,4074714
0400000US37,37,North Carolina,,2013,1240,Health,2533,10333291,188,395147,18547,2638,2721,10728438
0400000US37,37,North Carolina,,2013,1260,Hospitals,18034,72567055,1754,4410629,88886,18536,19788,76977684
0400000US37,37,North Carolina,,2013,1280,Social Insurance Administration,1535,7346697,126,220180,2643,1550,1661,7566877
0400000US37,37,North Carolina,,2013,1300,Solid Waste Management,294,1513387,0,0,0,294,294,1513387
0400000US37,37,North Carolina,,2013,1320,Sewerage,0,0,0,0,0,0,0,0
0400000US37,37,North Carolina,,2013,1340,Parks and Recreation,1456,6651404,58,96518,9507,1510,1514,6747922
0400000US37,37,North Carolina,,2013,1360,Housing and Community Development,0,0,0,0,0,0,0,0
0400000US37,37,North Carolina,,2013,1380,Natural Resources,4003,15138517,193,260707,11177,4066,4196,15399224
0400000US37,37,North Carolina,,2013,1400,Water Supply,0,0,0,0,0,0,0,0
0400000US37,37,North Carolina,,2013,1420,Electric Power,0,0,0,0,0,0,0,0
0400000US37,37,North Carolina,,2013,1440,Gas Supply,0,0,0,0,0,0,0,0
0400000US37,37,North Carolina,,2013,1460,Transit,0,0,0,0,0,0,0,0
0400000US37,37,North Carolina,,2013,1480,Education Total ,46322,249873702,40619,53768405,3078785,63718,86941,303642107
0400000US37,37,North Carolina,,2013,1481,Education - Elementary and Secondary Total ,0,0,0,0,0,0,0,0
0400000US37,37,North Carolina,,2013,14811,Education - Elementary and Secondary Instructional             ,0,0,0,0,0,0,0,0
0400000US37,37,North Carolina,,2013,14812,Education - Elementary and Secondary Other ,0,0,0,0,0,0,0,0
0400000US37,37,North Carolina,,2013,1482,Education - Higher Education Total ,42968,234700514,40376,53604231,3077154,60354,83344,288304745
0400000US37,37,North Carolina,,2013,14821,Education - Higher Education Instructional,15299,114660974,13950,30695424,1315901,22733,29249,145356398
0400000US37,37,North Carolina,,2013,14822,Education - Higher Education Other ,27669,120039540,26426,22908807,1761253,37621,54095,142948347
0400000US37,37,North Carolina,,2013,1483,Education - Other,3354,15173188,243,164174,1631,3364,3597,15337362
0400000US37,37,North Carolina,,2013,1500,Libraries                          ,0,0,0,0,0,0,0,0
0400000US37,37,North Carolina,,2013,1560,State liquor stores,0,0,0,0,0,0,0,0
0400000US37,37,North Carolina,,2013,1580,All other and unallocable,5180,22836647,618,1074397,64522,5546,5798,23911044
0400000US38,38,North Dakota,,2013,1000,Total - All Government Employment Functions,15769,69323287,10007,9189035,614293,19238,25776,78512322
0400000US38,38,North Dakota,,2013,1020,Financial Administration,654,2687404,48,72825,3154,671,702,2760229
0400000US38,38,North Dakota,,2013,1040,Other Government Administration,205,891506,167,110407,3899,227,372,1001913
0400000US38,38,North Dakota,,2013,1060,Judicial and Legal,566,2923332,50,34780,1801,576,616,2958112
0400000US38,38,North Dakota,,2013,1100,Police Protection Total,195,914441,4,8128,458,198,199,922569
0400000US38,38,North Dakota,,2013,1101,Police Protection - Persons with Power of Arrest       ,148,733936,0,0,0,148,148,733936
0400000US38,38,North Dakota,,2013,1102,Police Protection - Other ,47,180505,4,8128,458,50,51,188633
0400000US38,38,North Dakota,,2013,1120,Fire Protection Total ,0,0,0,0,0,0,0,0
0400000US38,38,North Dakota,,2013,1121,Fire Protection - Firefighters,0,0,0,0,0,0,0,0
0400000US38,38,North Dakota,,2013,1122,Fire Protection - Other ,0,0,0,0,0,0,0,0
0400000US38,38,North Dakota,,2013,1140,Corrections,796,3006902,80,182086,6048,830,876,3188988
0400000US38,38,North Dakota,,2013,1160,Highways,1004,5511814,5,10526,483,1007,1009,5522340
0400000US38,38,North Dakota,,2013,1180,Air Transportation,0,0,0,0,0,0,0,0
0400000US38,38,North Dakota,,2013,1200,Water Transport and Terminals       ,0,0,0,0,0,0,0,0
0400000US38,38,North Dakota,,2013,1220,Public Welfare,457,1535889,125,222556,14239,537,582,1758445
0400000US38,38,North Dakota,,2013,1240,Health,1253,4595737,253,286882,21964,1377,1506,4882619
0400000US38,38,North Dakota,,2013,1260,Hospitals,877,2546687,146,204680,7751,921,1023,2751367
0400000US38,38,North Dakota,,2013,1280,Social Insurance Administration,324,1304904,84,114729,6293,359,408,1419633
0400000US38,38,North Dakota,,2013,1300,Solid Waste Management,0,0,0,0,0,0,0,0
0400000US38,38,North Dakota,,2013,1320,Sewerage,0,0,0,0,0,0,0,0
0400000US38,38,North Dakota,,2013,1340,Parks and Recreation,176,548031,11,18886,1129,182,187,566917
0400000US38,38,North Dakota,,2013,1360,Housing and Community Development,0,0,0,0,0,0,0,0
0400000US38,38,North Dakota,,2013,1380,Natural Resources,564,2569785,34,46600,2225,576,598,2616385
0400000US38,38,North Dakota,,2013,1400,Water Supply,0,0,0,0,0,0,0,0
0400000US38,38,North Dakota,,2013,1420,Electric Power,0,0,0,0,0,0,0,0
0400000US38,38,North Dakota,,2013,1440,Gas Supply,0,0,0,0,0,0,0,0
0400000US38,38,North Dakota,,2013,1460,Transit,0,0,0,0,0,0,0,0
0400000US38,38,North Dakota,,2013,1480,Education Total ,7199,33358522,8889,7729848,537695,10239,16088,41088370
0400000US38,38,North Dakota,,2013,1481,Education - Elementary and Secondary Total ,0,0,0,0,0,0,0,0
0400000US38,38,North Dakota,,2013,14811,Education - Elementary and Secondary Instructional             ,0,0,0,0,0,0,0,0
0400000US38,38,North Dakota,,2013,14812,Education - Elementary and Secondary Other ,0,0,0,0,0,0,0,0
0400000US38,38,North Dakota,,2013,1482,Education - Higher Education Total ,6880,32150179,8844,7653151,534310,9902,15724,39803330
0400000US38,38,North Dakota,,2013,14821,Education - Higher Education Instructional,2244,14215885,2652,3815876,183666,3284,4896,18031761
0400000US38,38,North Dakota,,2013,14822,Education - Higher Education Other ,4636,17934294,6192,3837275,350644,6618,10828,21771569
0400000US38,38,North Dakota,,2013,1483,Education - Other,319,1208343,45,76697,3385,337,364,1285040
0400000US38,38,North Dakota,,2013,1500,Libraries                          ,0,0,0,0,0,0,0,0
0400000US38,38,North Dakota,,2013,1560,State liquor stores,0,0,0,0,0,0,0,0
0400000US38,38,North Dakota,,2013,1580,All other and unallocable,1499,6928333,111,146102,7154,1538,1610,7074435
0400000US39,39,Ohio,,2013,1000,Total - All Government Employment Functions,109084,561743272,79442,89335315,4940282,137045,188526,651078587
0400000US39,39,Ohio,,2013,1020,Financial Administration,6344,34291893,254,634068,29661,6513,6598,34925961
0400000US39,39,Ohio,,2013,1040,Other Government Administration,713,3208057,148,110792,10017,770,861,3318849
0400000US39,39,Ohio,,2013,1060,Judicial and Legal,2751,16228585,537,1339090,41191,2984,3288,17567675
0400000US39,39,Ohio,,2013,1100,Police Protection Total,2606,13189721,8,27276,1399,2614,2614,13216997
0400000US39,39,Ohio,,2013,1101,Police Protection - Persons with Power of Arrest       ,1433,8309526,0,0,0,1433,1433,8309526
0400000US39,39,Ohio,,2013,1102,Police Protection - Other ,1173,4880195,8,27276,1399,1181,1181,4907471
0400000US39,39,Ohio,,2013,1120,Fire Protection Total ,0,0,0,0,0,0,0,0
0400000US39,39,Ohio,,2013,1121,Fire Protection - Firefighters,0,0,0,0,0,0,0,0
0400000US39,39,Ohio,,2013,1122,Fire Protection - Other ,0,0,0,0,0,0,0,0
0400000US39,39,Ohio,,2013,1140,Corrections,13218,58848766,27,75627,3784,13239,13245,58924393
0400000US39,39,Ohio,,2013,1160,Highways,5721,27452898,753,1662446,103026,6303,6474,29115344
0400000US39,39,Ohio,,2013,1180,Air Transportation,0,0,0,0,0,0,0,0
0400000US39,39,Ohio,,2013,1200,Water Transport and Terminals       ,0,0,0,0,0,0,0,0
0400000US39,39,Ohio,,2013,1220,Public Welfare,2430,13495418,325,668954,48619,2715,2755,14164372
0400000US39,39,Ohio,,2013,1240,Health,3042,17143472,207,491781,25934,3189,3249,17635253
0400000US39,39,Ohio,,2013,1260,Hospitals,12614,61721377,5902,13346419,533813,15630,18516,75067796
0400000US39,39,Ohio,,2013,1280,Social Insurance Administration,1988,8514051,213,324894,18999,2110,2201,8838945
0400000US39,39,Ohio,,2013,1300,Solid Waste Management,0,0,0,0,0,0,0,0
0400000US39,39,Ohio,,2013,1320,Sewerage,0,0,0,0,0,0,0,0
0400000US39,39,Ohio,,2013,1340,Parks and Recreation,393,1668343,268,369429,24264,530,661,2037772
0400000US39,39,Ohio,,2013,1360,Housing and Community Development,0,0,0,0,0,0,0,0
0400000US39,39,Ohio,,2013,1380,Natural Resources,2223,9868408,384,728202,43704,2470,2607,10596610
0400000US39,39,Ohio,,2013,1400,Water Supply,0,0,0,0,0,0,0,0
0400000US39,39,Ohio,,2013,1420,Electric Power,0,0,0,0,0,0,0,0
0400000US39,39,Ohio,,2013,1440,Gas Supply,0,0,0,0,0,0,0,0
0400000US39,39,Ohio,,2013,1460,Transit,0,0,0,0,0,0,0,0
0400000US39,39,Ohio,,2013,1480,Education Total ,50660,272780491,70088,68979703,4028881,73446,120748,341760194
0400000US39,39,Ohio,,2013,1481,Education - Elementary and Secondary Total ,0,0,0,0,0,0,0,0
0400000US39,39,Ohio,,2013,14811,Education - Elementary and Secondary Instructional             ,0,0,0,0,0,0,0,0
0400000US39,39,Ohio,,2013,14812,Education - Elementary and Secondary Other ,0,0,0,0,0,0,0,0
0400000US39,39,Ohio,,2013,1482,Education - Higher Education Total ,48739,262766876,69913,68683985,4015698,71450,118652,331450861
0400000US39,39,Ohio,,2013,14821,Education - Higher Education Instructional,16471,119140479,21059,32442881,1195910,23242,37530,151583360
0400000US39,39,Ohio,,2013,14822,Education - Higher Education Other ,32268,143626397,48854,36241104,2819788,48208,81122,179867501
0400000US39,39,Ohio,,2013,1483,Education - Other,1921,10013615,175,295718,13183,1996,2096,10309333
0400000US39,39,Ohio,,2013,1500,Libraries                          ,0,0,0,0,0,0,0,0
0400000US39,39,Ohio,,2013,1560,State liquor stores,0,0,0,0,0,0,0,0
0400000US39,39,Ohio,,2013,1580,All other and unallocable,4381,23331792,328,576634,26990,4532,4709,23908426
0400000US40,40,Oklahoma,,2013,1000,Total - All Government Employment Functions,59679,239374594,26689,24208236,1439644,67837,86368,263582830
0400000US40,40,Oklahoma,,2013,1020,Financial Administration,2419,10490970,53,68294,3836,2441,2472,10559264
0400000US40,40,Oklahoma,,2013,1040,Other Government Administration,455,1747740,92,167313,11275,519,547,1915053
0400000US40,40,Oklahoma,,2013,1060,Judicial and Legal,2730,12203812,110,144592,8227,2777,2840,12348404
0400000US40,40,Oklahoma,,2013,1100,Police Protection Total,1864,8316113,83,104410,8175,1910,1947,8420523
0400000US40,40,Oklahoma,,2013,1101,Police Protection - Persons with Power of Arrest       ,985,5285545,11,12578,452,988,996,5298123
0400000US40,40,Oklahoma,,2013,1102,Police Protection - Other ,879,3030568,72,91832,7723,922,951,3122400
0400000US40,40,Oklahoma,,2013,1120,Fire Protection Total ,0,0,0,0,0,0,0,0
0400000US40,40,Oklahoma,,2013,1121,Fire Protection - Firefighters,0,0,0,0,0,0,0,0
0400000US40,40,Oklahoma,,2013,1122,Fire Protection - Other ,0,0,0,0,0,0,0,0
0400000US40,40,Oklahoma,,2013,1140,Corrections,4632,14473250,62,109032,4213,4656,4694,14582282
0400000US40,40,Oklahoma,,2013,1160,Highways,2830,10473303,0,0,0,2830,2830,10473303
0400000US40,40,Oklahoma,,2013,1180,Air Transportation,9,45465,0,0,0,9,9,45465
0400000US40,40,Oklahoma,,2013,1200,Water Transport and Terminals       ,0,0,0,0,0,0,0,0
0400000US40,40,Oklahoma,,2013,1220,Public Welfare,6887,21562848,13,24470,1088,6894,6900,21587318
0400000US40,40,Oklahoma,,2013,1240,Health,5122,20081724,319,590426,28947,5286,5441,20672150
0400000US40,40,Oklahoma,,2013,1260,Hospitals,1704,5346894,61,96158,8336,1751,1765,5443052
0400000US40,40,Oklahoma,,2013,1280,Social Insurance Administration,1278,4880389,97,272177,6750,1316,1375,5152566
0400000US40,40,Oklahoma,,2013,1300,Solid Waste Management,77,411383,7,4661,436,79,84,416044
0400000US40,40,Oklahoma,,2013,1320,Sewerage,0,0,0,0,0,0,0,0
0400000US40,40,Oklahoma,,2013,1340,Parks and Recreation,572,1587165,285,290477,29145,737,857,1877642
0400000US40,40,Oklahoma,,2013,1360,Housing and Community Development,0,0,0,0,0,0,0,0
0400000US40,40,Oklahoma,,2013,1380,Natural Resources,1575,5559120,842,777917,45477,1832,2417,6337037
0400000US40,40,Oklahoma,,2013,1400,Water Supply,0,0,0,0,0,0,0,0
0400000US40,40,Oklahoma,,2013,1420,Electric Power,570,3197302,10,15012,826,574,580,3212314
0400000US40,40,Oklahoma,,2013,1440,Gas Supply,0,0,0,0,0,0,0,0
0400000US40,40,Oklahoma,,2013,1460,Transit,0,0,0,0,0,0,0,0
0400000US40,40,Oklahoma,,2013,1480,Education Total ,24674,109677449,24545,21382847,1272611,31887,49219,131060296
0400000US40,40,Oklahoma,,2013,1481,Education - Elementary and Secondary Total ,0,0,0,0,0,0,0,0
0400000US40,40,Oklahoma,,2013,14811,Education - Elementary and Secondary Instructional             ,0,0,0,0,0,0,0,0
0400000US40,40,Oklahoma,,2013,14812,Education - Elementary and Secondary Other ,0,0,0,0,0,0,0,0
0400000US40,40,Oklahoma,,2013,1482,Education - Higher Education Total ,22993,103599582,24487,21319694,1268815,30184,47480,124919276
0400000US40,40,Oklahoma,,2013,14821,Education - Higher Education Instructional,6461,43069900,5469,6729859,201719,7604,11930,49799759
0400000US40,40,Oklahoma,,2013,14822,Education - Higher Education Other ,16532,60529682,19018,14589835,1067096,22580,35550,75119517
0400000US40,40,Oklahoma,,2013,1483,Education - Other,1681,6077867,58,63153,3796,1703,1739,6141020
0400000US40,40,Oklahoma,,2013,1500,Libraries                          ,0,0,0,0,0,0,0,0
0400000US40,40,Oklahoma,,2013,1560,State liquor stores,0,0,0,0,0,0,0,0
0400000US40,40,Oklahoma,,2013,1580,All other and unallocable,2281,9319667,110,160450,10302,2339,2391,9480117
0400000US41,41,Oregon,,2013,1000,Total - All Government Employment Functions,56933,272649181,24511,40101349,1645771,66229,81444,312750530
0400000US41,41,Oregon,,2013,1020,Financial Administration,3792,16626657,177,273140,14497,3874,3969,16899797
0400000US41,41,Oregon,,2013,1040,Other Government Administration,997,4650838,167,318447,14815,1081,1164,4969285
0400000US41,41,Oregon,,2013,1060,Judicial and Legal,2834,13536242,157,497053,15929,2923,2991,14033295
0400000US41,41,Oregon,,2013,1100,Police Protection Total,1280,6841992,185,215020,9506,1334,1465,7057012
0400000US41,41,Oregon,,2013,1101,Police Protection - Persons with Power of Arrest       ,680,4176635,35,74915,3047,697,715,4251550
0400000US41,41,Oregon,,2013,1102,Police Protection - Other ,600,2665357,150,140105,6459,637,750,2805462
0400000US41,41,Oregon,,2013,1120,Fire Protection Total ,0,0,0,0,0,0,0,0
0400000US41,41,Oregon,,2013,1121,Fire Protection - Firefighters,0,0,0,0,0,0,0,0
0400000US41,41,Oregon,,2013,1122,Fire Protection - Other ,0,0,0,0,0,0,0,0
0400000US41,41,Oregon,,2013,1140,Corrections,5016,22030303,135,249607,9242,5068,5151,22279910
0400000US41,41,Oregon,,2013,1160,Highways,3501,17275180,259,611507,29511,3668,3760,17886687
0400000US41,41,Oregon,,2013,1180,Air Transportation,12,55035,1,1550,80,12,13,56585
0400000US41,41,Oregon,,2013,1200,Water Transport and Terminals       ,0,0,0,0,0,0,0,0
0400000US41,41,Oregon,,2013,1220,Public Welfare,6829,24901197,380,684192,30407,7001,7209,25585389
0400000US41,41,Oregon,,2013,1240,Health,2054,8945849,170,333437,13090,2128,2224,9279286
0400000US41,41,Oregon,,2013,1260,Hospitals,5268,25073955,3248,15988502,468640,7915,8516,41062457
0400000US41,41,Oregon,,2013,1280,Social Insurance Administration,2145,12171400,104,349018,10445,2204,2249,12520418
0400000US41,41,Oregon,,2013,1300,Solid Waste Management,0,0,0,0,0,0,0,0
0400000US41,41,Oregon,,2013,1320,Sewerage,0,0,0,0,0,0,0,0
0400000US41,41,Oregon,,2013,1340,Parks and Recreation,441,1691898,13,23618,1294,448,454,1715516
0400000US41,41,Oregon,,2013,1360,Housing and Community Development,0,0,0,0,0,0,0,0
0400000US41,41,Oregon,,2013,1380,Natural Resources,2427,10170818,252,387505,20983,2546,2679,10558323
0400000US41,41,Oregon,,2013,1400,Water Supply,0,0,0,0,0,0,0,0
0400000US41,41,Oregon,,2013,1420,Electric Power,0,0,0,0,0,0,0,0
0400000US41,41,Oregon,,2013,1440,Gas Supply,0,0,0,0,0,0,0,0
0400000US41,41,Oregon,,2013,1460,Transit,0,0,0,0,0,0,0,0
0400000US41,41,Oregon,,2013,1480,Education Total ,18704,101496046,19156,20027589,1001549,24364,37860,121523635
0400000US41,41,Oregon,,2013,1481,Education - Elementary and Secondary Total ,0,0,0,0,0,0,0,0
0400000US41,41,Oregon,,2013,14811,Education - Elementary and Secondary Instructional             ,0,0,0,0,0,0,0,0
0400000US41,41,Oregon,,2013,14812,Education - Elementary and Secondary Other ,0,0,0,0,0,0,0,0
0400000US41,41,Oregon,,2013,1482,Education - Higher Education Total ,18071,98621687,19106,19961909,998130,23711,37177,118583596
0400000US41,41,Oregon,,2013,14821,Education - Higher Education Instructional,9988,67018250,3251,7267691,202491,11132,13239,74285941
0400000US41,41,Oregon,,2013,14822,Education - Higher Education Other ,8083,31603437,15855,12694218,795639,12579,23938,44297655
0400000US41,41,Oregon,,2013,1483,Education - Other,633,2874359,50,65680,3419,653,683,2940039
0400000US41,41,Oregon,,2013,1500,Libraries                          ,0,0,0,0,0,0,0,0
0400000US41,41,Oregon,,2013,1560,State liquor stores,246,902928,6,8380,500,249,252,911308
0400000US41,41,Oregon,,2013,1580,All other and unallocable,1387,6278843,101,132784,5283,1414,1488,6411627
0400000US42,42,Pennsylvania,,2013,1000,Total - All Government Employment Functions,140949,666985229,64307,103027152,3072516,159018,205256,770012381
0400000US42,42,Pennsylvania,,2013,1020,Financial Administration,6421,27762358,988,2186910,102201,7037,7409,29949268
0400000US42,42,Pennsylvania,,2013,1040,Other Government Administration,2754,11813729,471,2173948,52469,3068,3225,13987677
0400000US42,42,Pennsylvania,,2013,1060,Judicial and Legal,3053,25055824,0,0,0,3053,3053,25055824
0400000US42,42,Pennsylvania,,2013,1100,Police Protection Total,6461,38617508,317,921816,16813,6562,6778,39539324
0400000US42,42,Pennsylvania,,2013,1101,Police Protection - Persons with Power of Arrest       ,5112,30545405,7,12418,724,5116,5119,30557823
0400000US42,42,Pennsylvania,,2013,1102,Police Protection - Other ,1349,8072103,310,909398,16089,1446,1659,8981501
0400000US42,42,Pennsylvania,,2013,1120,Fire Protection Total ,0,0,0,0,0,0,0,0
0400000US42,42,Pennsylvania,,2013,1121,Fire Protection - Firefighters,0,0,0,0,0,0,0,0
0400000US42,42,Pennsylvania,,2013,1122,Fire Protection - Other ,0,0,0,0,0,0,0,0
0400000US42,42,Pennsylvania,,2013,1140,Corrections,18073,80990992,717,2237611,51695,18384,18790,83228603
0400000US42,42,Pennsylvania,,2013,1160,Highways,12499,48589752,2822,6484073,207527,13746,15321,55073825
0400000US42,42,Pennsylvania,,2013,1180,Air Transportation,119,435298,31,69086,2212,132,150,504384
0400000US42,42,Pennsylvania,,2013,1200,Water Transport and Terminals       ,184,801764,52,151194,4635,212,236,952958
0400000US42,42,Pennsylvania,,2013,1220,Public Welfare,10558,40089285,1713,3392388,101802,11171,12271,43481673
0400000US42,42,Pennsylvania,,2013,1240,Health,1705,8131411,375,1062825,10745,1770,2080,9194236
0400000US42,42,Pennsylvania,,2013,1260,Hospitals,10625,35906419,1716,2706397,77882,11084,12341,38612816
0400000US42,42,Pennsylvania,,2013,1280,Social Insurance Administration,3961,15777209,680,1934524,45047,4232,4641,17711733
0400000US42,42,Pennsylvania,,2013,1300,Solid Waste Management,0,0,0,0,0,0,0,0
0400000US42,42,Pennsylvania,,2013,1320,Sewerage,0,0,0,0,0,0,0,0
0400000US42,42,Pennsylvania,,2013,1340,Parks and Recreation,1589,6541906,1339,3304261,167901,2600,2928,9846167
0400000US42,42,Pennsylvania,,2013,1360,Housing and Community Development,0,0,0,0,0,0,0,0
0400000US42,42,Pennsylvania,,2013,1380,Natural Resources,5093,23594029,2678,5333757,115176,5767,7771,28927786
0400000US42,42,Pennsylvania,,2013,1400,Water Supply,0,0,0,0,0,0,0,0
0400000US42,42,Pennsylvania,,2013,1420,Electric Power,0,0,0,0,0,0,0,0
0400000US42,42,Pennsylvania,,2013,1440,Gas Supply,0,0,0,0,0,0,0,0
0400000US42,42,Pennsylvania,,2013,1460,Transit,0,0,0,0,0,0,0,0
0400000US42,42,Pennsylvania,,2013,1480,Education Total ,49142,266456872,47164,65204012,1852257,59897,96306,331660884
0400000US42,42,Pennsylvania,,2013,1481,Education - Elementary and Secondary Total ,0,0,0,0,0,0,0,0
0400000US42,42,Pennsylvania,,2013,14811,Education - Elementary and Secondary Instructional             ,0,0,0,0,0,0,0,0
0400000US42,42,Pennsylvania,,2013,14812,Education - Elementary and Secondary Other ,0,0,0,0,0,0,0,0
0400000US42,42,Pennsylvania,,2013,1482,Education - Higher Education Total ,44629,248568441,46840,64332298,1832919,55268,91469,312900739
0400000US42,42,Pennsylvania,,2013,14821,Education - Higher Education Instructional,14995,121605832,12934,37570019,493329,17848,27929,159175851
0400000US42,42,Pennsylvania,,2013,14822,Education - Higher Education Other ,29634,126962609,33906,26762279,1339590,37420,63540,153724888
0400000US42,42,Pennsylvania,,2013,1483,Education - Other,4513,17888431,324,871714,19338,4629,4837,18760145
0400000US42,42,Pennsylvania,,2013,1500,Libraries                          ,0,0,0,0,0,0,0,0
0400000US42,42,Pennsylvania,,2013,1560,State liquor stores,3113,10599624,2399,4685785,218351,4428,5512,15285409
0400000US42,42,Pennsylvania,,2013,1580,All other and unallocable,5599,25821249,845,1178565,45803,5875,6444,26999814
0400000US44,44,Rhode Island,,2013,1000,Total - All Government Employment Functions,16910,94541154,7038,6778460,238846,18456,23948,101319614
0400000US44,44,Rhode Island,,2013,1020,Financial Administration,859,4666631,5,17801,467,862,864,4684432
0400000US44,44,Rhode Island,,2013,1040,Other Government Administration,725,3876291,337,347672,8126,778,1062,4223963
0400000US44,44,Rhode Island,,2013,1060,Judicial and Legal,1150,6779682,15,39253,1435,1160,1165,6818935
0400000US44,44,Rhode Island,,2013,1100,Police Protection Total,317,2276701,2,3144,78,318,319,2279845
0400000US44,44,Rhode Island,,2013,1101,Police Protection - Persons with Power of Arrest       ,238,1800318,0,0,0,238,238,1800318
0400000US44,44,Rhode Island,,2013,1102,Police Protection - Other ,79,476383,2,3144,78,80,81,479527
0400000US44,44,Rhode Island,,2013,1120,Fire Protection Total ,0,0,0,0,0,0,0,0
0400000US44,44,Rhode Island,,2013,1121,Fire Protection - Firefighters,0,0,0,0,0,0,0,0
0400000US44,44,Rhode Island,,2013,1122,Fire Protection - Other ,0,0,0,0,0,0,0,0
0400000US44,44,Rhode Island,,2013,1140,Corrections,1553,9846829,0,0,0,1553,1553,9846829
0400000US44,44,Rhode Island,,2013,1160,Highways,719,3889929,52,58880,3797,741,771,3948809
0400000US44,44,Rhode Island,,2013,1180,Air Transportation,145,919185,1,1063,18,145,146,920248
0400000US44,44,Rhode Island,,2013,1200,Water Transport and Terminals       ,0,0,0,0,0,0,0,0
0400000US44,44,Rhode Island,,2013,1220,Public Welfare,1214,7180916,12,24554,1242,1222,1226,7205470
0400000US44,44,Rhode Island,,2013,1240,Health,920,5084844,24,13587,1158,928,944,5098431
0400000US44,44,Rhode Island,,2013,1260,Hospitals,791,4255525,1,4032,100,792,792,4259557
0400000US44,44,Rhode Island,,2013,1280,Social Insurance Administration,400,2016495,4,15969,567,404,404,2032464
0400000US44,44,Rhode Island,,2013,1300,Solid Waste Management,101,611758,4,5806,89,102,105,617564
0400000US44,44,Rhode Island,,2013,1320,Sewerage,250,1208072,0,0,0,250,250,1208072
0400000US44,44,Rhode Island,,2013,1340,Parks and Recreation,61,207328,0,0,0,61,61,207328
0400000US44,44,Rhode Island,,2013,1360,Housing and Community Development,0,0,0,0,0,0,0,0
0400000US44,44,Rhode Island,,2013,1380,Natural Resources,376,2205721,0,0,0,376,376,2205721
0400000US44,44,Rhode Island,,2013,1400,Water Supply,0,0,0,0,0,0,0,0
0400000US44,44,Rhode Island,,2013,1420,Electric Power,0,0,0,0,0,0,0,0
0400000US44,44,Rhode Island,,2013,1440,Gas Supply,0,0,0,0,0,0,0,0
0400000US44,44,Rhode Island,,2013,1460,Transit,754,3818013,0,0,0,754,754,3818013
0400000US44,44,Rhode Island,,2013,1480,Education Total ,4864,25755517,6525,6148964,217348,6272,11389,31904481
0400000US44,44,Rhode Island,,2013,1481,Education - Elementary and Secondary Total ,414,2156220,61,50826,3585,441,475,2207046
0400000US44,44,Rhode Island,,2013,14811,Education - Elementary and Secondary Instructional             ,311,1758311,20,26301,667,316,331,1784612
0400000US44,44,Rhode Island,,2013,14812,Education - Elementary and Secondary Other ,103,397909,41,24525,2918,125,144,422434
0400000US44,44,Rhode Island,,2013,1482,Education - Higher Education Total ,3945,20540957,6455,6080324,212996,5321,10400,26621281
0400000US44,44,Rhode Island,,2013,14821,Education - Higher Education Instructional,1363,8698531,2193,3780035,81057,1887,3556,12478566
0400000US44,44,Rhode Island,,2013,14822,Education - Higher Education Other ,2582,11842426,4262,2300289,131939,3434,6844,14142715
0400000US44,44,Rhode Island,,2013,1483,Education - Other,505,3058340,9,17814,767,510,514,3076154
0400000US44,44,Rhode Island,,2013,1500,Libraries                          ,0,0,0,0,0,0,0,0
0400000US44,44,Rhode Island,,2013,1560,State liquor stores,0,0,0,0,0,0,0,0
0400000US44,44,Rhode Island,,2013,1580,All other and unallocable,1711,9941717,56,97735,4421,1738,1767,10039452
0400000US45,45,South Carolina,,2013,1000,Total - All Government Employment Functions,70570,278455692,21610,23801054,1394921,78857,92180,302256746
0400000US45,45,South Carolina,,2013,1020,Financial Administration,3364,11653702,202,332454,20964,3490,3566,11986156
0400000US45,45,South Carolina,,2013,1040,Other Government Administration,540,2170969,497,336829,22156,674,1037,2507798
0400000US45,45,South Carolina,,2013,1060,Judicial and Legal,809,3954642,13,23570,1084,815,822,3978212
0400000US45,45,South Carolina,,2013,1100,Police Protection Total,2016,7448348,4,7284,378,2017,2020,7455632
0400000US45,45,South Carolina,,2013,1101,Police Protection - Persons with Power of Arrest       ,1345,5274574,1,1800,60,1345,1346,5276374
0400000US45,45,South Carolina,,2013,1102,Police Protection - Other ,671,2173774,3,5484,318,672,674,2179258
0400000US45,45,South Carolina,,2013,1120,Fire Protection Total ,0,0,0,0,0,0,0,0
0400000US45,45,South Carolina,,2013,1121,Fire Protection - Firefighters,0,0,0,0,0,0,0,0
0400000US45,45,South Carolina,,2013,1122,Fire Protection - Other ,0,0,0,0,0,0,0,0
0400000US45,45,South Carolina,,2013,1140,Corrections,8138,23201546,62,111980,5900,8174,8200,23313526
0400000US45,45,South Carolina,,2013,1160,Highways,4423,14485882,8,19484,1040,4429,4431,14505366
0400000US45,45,South Carolina,,2013,1180,Air Transportation,13,61332,2,2100,56,13,15,63432
0400000US45,45,South Carolina,,2013,1200,Water Transport and Terminals       ,480,2769801,5,2673,182,481,485,2772474
0400000US45,45,South Carolina,,2013,1220,Public Welfare,4680,13142972,5,7382,440,4683,4685,13150354
0400000US45,45,South Carolina,,2013,1240,Health,5196,17929105,376,864415,38677,5427,5572,18793520
0400000US45,45,South Carolina,,2013,1260,Hospitals,6767,20191084,331,1315808,39818,6995,7098,21506892
0400000US45,45,South Carolina,,2013,1280,Social Insurance Administration,1191,3823772,78,121498,8496,1242,1269,3945270
0400000US45,45,South Carolina,,2013,1300,Solid Waste Management,0,0,0,0,0,0,0,0
0400000US45,45,South Carolina,,2013,1320,Sewerage,0,0,0,0,0,0,0,0
0400000US45,45,South Carolina,,2013,1340,Parks and Recreation,764,1691720,43,30428,2878,781,807,1722148
0400000US45,45,South Carolina,,2013,1360,Housing and Community Development,139,578140,1,350,10,139,140,578490
0400000US45,45,South Carolina,,2013,1380,Natural Resources,1926,6151526,225,195500,22088,2060,2151,6347026
0400000US45,45,South Carolina,,2013,1400,Water Supply,13,76747,0,0,0,13,13,76747
0400000US45,45,South Carolina,,2013,1420,Electric Power,1787,11348710,9,35201,1231,1794,1796,11383911
0400000US45,45,South Carolina,,2013,1440,Gas Supply,0,0,0,0,0,0,0,0
0400000US45,45,South Carolina,,2013,1460,Transit,0,0,0,0,0,0,0,0
0400000US45,45,South Carolina,,2013,1480,Education Total ,26934,132760544,19691,20316368,1225153,34213,46625,153076912
0400000US45,45,South Carolina,,2013,1481,Education - Elementary and Secondary Total ,0,0,0,0,0,0,0,0
0400000US45,45,South Carolina,,2013,14811,Education - Elementary and Secondary Instructional             ,0,0,0,0,0,0,0,0
0400000US45,45,South Carolina,,2013,14812,Education - Elementary and Secondary Other ,0,0,0,0,0,0,0,0
0400000US45,45,South Carolina,,2013,1482,Education - Higher Education Total ,24046,122245054,19518,20049480,1210901,31239,43564,142294534
0400000US45,45,South Carolina,,2013,14821,Education - Higher Education Instructional,8644,57297039,7743,9753185,428379,11195,16387,67050224
0400000US45,45,South Carolina,,2013,14822,Education - Higher Education Other ,15402,64948015,11775,10296295,782522,20044,27177,75244310
0400000US45,45,South Carolina,,2013,1483,Education - Other,2888,10515490,173,266888,14252,2974,3061,10782378
0400000US45,45,South Carolina,,2013,1500,Libraries                          ,34,121400,0,0,0,34,34,121400
0400000US45,45,South Carolina,,2013,1560,State liquor stores,0,0,0,0,0,0,0,0
0400000US45,45,South Carolina,,2013,1580,All other and unallocable,1356,4893750,58,77730,4370,1383,1414,4971480
0400000US46,46,South Dakota,,2013,1000,Total - All Government Employment Functions,12536,49957708,6234,5320247,337799,14442,18770,55277955
0400000US46,46,South Dakota,,2013,1020,Financial Administration,433,1943975,15,27306,1575,442,448,1971281
0400000US46,46,South Dakota,,2013,1040,Other Government Administration,305,1205813,22,31308,1957,316,327,1237121
0400000US46,46,South Dakota,,2013,1060,Judicial and Legal,597,2638441,87,124892,7880,642,684,2763333
0400000US46,46,South Dakota,,2013,1100,Police Protection Total,307,1213160,19,33778,1560,316,326,1246938
0400000US46,46,South Dakota,,2013,1101,Police Protection - Persons with Power of Arrest       ,194,872906,0,0,0,194,194,872906
0400000US46,46,South Dakota,,2013,1102,Police Protection - Other ,113,340254,19,33778,1560,122,132,374032
0400000US46,46,South Dakota,,2013,1120,Fire Protection Total ,0,0,0,0,0,0,0,0
0400000US46,46,South Dakota,,2013,1121,Fire Protection - Firefighters,0,0,0,0,0,0,0,0
0400000US46,46,South Dakota,,2013,1122,Fire Protection - Other ,0,0,0,0,0,0,0,0
0400000US46,46,South Dakota,,2013,1140,Corrections,853,2737276,25,36855,2726,868,878,2774131
0400000US46,46,South Dakota,,2013,1160,Highways,957,3841387,79,89665,5646,989,1036,3931052
0400000US46,46,South Dakota,,2013,1180,Air Transportation,0,0,0,0,0,0,0,0
0400000US46,46,South Dakota,,2013,1200,Water Transport and Terminals       ,0,0,0,0,0,0,0,0
0400000US46,46,South Dakota,,2013,1220,Public Welfare,1640,5643158,124,207191,13352,1715,1764,5850349
0400000US46,46,South Dakota,,2013,1240,Health,505,2127711,134,372976,16953,601,639,2500687
0400000US46,46,South Dakota,,2013,1260,Hospitals,348,1046593,49,68878,4836,375,397,1115471
0400000US46,46,South Dakota,,2013,1280,Social Insurance Administration,268,776546,5,7757,483,271,273,784303
0400000US46,46,South Dakota,,2013,1300,Solid Waste Management,0,0,0,0,0,0,0,0
0400000US46,46,South Dakota,,2013,1320,Sewerage,0,0,0,0,0,0,0,0
0400000US46,46,South Dakota,,2013,1340,Parks and Recreation,121,396249,24,21029,1944,132,145,417278
0400000US46,46,South Dakota,,2013,1360,Housing and Community Development,0,0,0,0,0,0,0,0
0400000US46,46,South Dakota,,2013,1380,Natural Resources,782,2836651,477,519046,33849,973,1259,3355697
0400000US46,46,South Dakota,,2013,1400,Water Supply,0,0,0,0,0,0,0,0
0400000US46,46,South Dakota,,2013,1420,Electric Power,0,0,0,0,0,0,0,0
0400000US46,46,South Dakota,,2013,1440,Gas Supply,0,0,0,0,0,0,0,0
0400000US46,46,South Dakota,,2013,1460,Transit,0,0,0,0,0,0,0,0
0400000US46,46,South Dakota,,2013,1480,Education Total ,4624,20417165,5128,3719565,240799,5983,9752,24136730
0400000US46,46,South Dakota,,2013,1481,Education - Elementary and Secondary Total ,0,0,0,0,0,0,0,0
0400000US46,46,South Dakota,,2013,14811,Education - Elementary and Secondary Instructional             ,0,0,0,0,0,0,0,0
0400000US46,46,South Dakota,,2013,14812,Education - Elementary and Secondary Other ,0,0,0,0,0,0,0,0
0400000US46,46,South Dakota,,2013,1482,Education - Higher Education Total ,4275,19144160,5110,3694946,238875,5623,9385,22839106
0400000US46,46,South Dakota,,2013,14821,Education - Higher Education Instructional,1568,9639137,1443,2067970,88996,2070,3011,11707107
0400000US46,46,South Dakota,,2013,14822,Education - Higher Education Other ,2707,9505023,3667,1626976,149879,3553,6374,11131999
0400000US46,46,South Dakota,,2013,1483,Education - Other,349,1273005,18,24619,1924,360,367,1297624
0400000US46,46,South Dakota,,2013,1500,Libraries                          ,0,0,0,0,0,0,0,0
0400000US46,46,South Dakota,,2013,1560,State liquor stores,0,0,0,0,0,0,0,0
0400000US46,46,South Dakota,,2013,1580,All other and unallocable,796,3133583,46,60001,4239,819,842,3193584
0400000US47,47,Tennessee,,2013,1000,Total - All Government Employment Functions,71109,288628967,27421,26974917,1608393,80587,98530,315603884
0400000US47,47,Tennessee,,2013,1020,Financial Administration,3253,14059630,32,52022,3635,3274,3285,14111652
0400000US47,47,Tennessee,,2013,1040,Other Government Administration,757,3194358,17,17813,697,762,774,3212171
0400000US47,47,Tennessee,,2013,1060,Judicial and Legal,2443,13386646,46,63830,2575,2458,2489,13450476
0400000US47,47,Tennessee,,2013,1100,Police Protection Total,1603,7786650,6,13494,582,1607,1609,7800144
0400000US47,47,Tennessee,,2013,1101,Police Protection - Persons with Power of Arrest       ,1211,6374922,0,0,0,1211,1211,6374922
0400000US47,47,Tennessee,,2013,1102,Police Protection - Other ,392,1411728,6,13494,582,396,398,1425222
0400000US47,47,Tennessee,,2013,1120,Fire Protection Total ,0,0,0,0,0,0,0,0
0400000US47,47,Tennessee,,2013,1121,Fire Protection - Firefighters,0,0,0,0,0,0,0,0
0400000US47,47,Tennessee,,2013,1122,Fire Protection - Other ,0,0,0,0,0,0,0,0
0400000US47,47,Tennessee,,2013,1140,Corrections,7035,20734542,40,88508,5214,7067,7075,20823050
0400000US47,47,Tennessee,,2013,1160,Highways,3598,12705940,0,0,0,3598,3598,12705940
0400000US47,47,Tennessee,,2013,1180,Air Transportation,0,0,0,0,0,0,0,0
0400000US47,47,Tennessee,,2013,1200,Water Transport and Terminals       ,0,0,0,0,0,0,0,0
0400000US47,47,Tennessee,,2013,1220,Public Welfare,7512,24933062,7,14366,710,7516,7519,24947428
0400000US47,47,Tennessee,,2013,1240,Health,4111,17323923,151,405354,16723,4207,4262,17729277
0400000US47,47,Tennessee,,2013,1260,Hospitals,3726,13655369,115,438708,17309,3824,3841,14094077
0400000US47,47,Tennessee,,2013,1280,Social Insurance Administration,1154,3823104,261,484058,34342,1361,1415,4307162
0400000US47,47,Tennessee,,2013,1300,Solid Waste Management,0,0,0,0,0,0,0,0
0400000US47,47,Tennessee,,2013,1320,Sewerage,0,0,0,0,0,0,0,0
0400000US47,47,Tennessee,,2013,1340,Parks and Recreation,966,2452918,211,160386,17912,1074,1177,2613304
0400000US47,47,Tennessee,,2013,1360,Housing and Community Development,0,0,0,0,0,0,0,0
0400000US47,47,Tennessee,,2013,1380,Natural Resources,3474,14168458,527,746376,59276,3819,4001,14914834
0400000US47,47,Tennessee,,2013,1400,Water Supply,0,0,0,0,0,0,0,0
0400000US47,47,Tennessee,,2013,1420,Electric Power,0,0,0,0,0,0,0,0
0400000US47,47,Tennessee,,2013,1440,Gas Supply,0,0,0,0,0,0,0,0
0400000US47,47,Tennessee,,2013,1460,Transit,0,0,0,0,0,0,0,0
0400000US47,47,Tennessee,,2013,1480,Education Total ,28812,130220964,25901,24404798,1446056,37335,54713,154625762
0400000US47,47,Tennessee,,2013,1481,Education - Elementary and Secondary Total ,0,0,0,0,0,0,0,0
0400000US47,47,Tennessee,,2013,14811,Education - Elementary and Secondary Instructional             ,0,0,0,0,0,0,0,0
0400000US47,47,Tennessee,,2013,14812,Education - Elementary and Secondary Other ,0,0,0,0,0,0,0,0
0400000US47,47,Tennessee,,2013,1482,Education - Higher Education Total ,26746,122358987,25644,24129061,1432606,35188,52390,146488048
0400000US47,47,Tennessee,,2013,14821,Education - Higher Education Instructional,9025,56331845,10631,12781986,584376,12501,19656,69113831
0400000US47,47,Tennessee,,2013,14822,Education - Higher Education Other ,17721,66027142,15013,11347075,848230,22687,32734,77374217
0400000US47,47,Tennessee,,2013,1483,Education - Other,2066,7861977,257,275737,13450,2147,2323,8137714
0400000US47,47,Tennessee,,2013,1500,Libraries                          ,0,0,0,0,0,0,0,0
0400000US47,47,Tennessee,,2013,1560,State liquor stores,0,0,0,0,0,0,0,0
0400000US47,47,Tennessee,,2013,1580,All other and unallocable,2665,10183403,107,85204,3362,2685,2772,10268607
0400000US48,48,Texas,,2013,1000,Total - All Government Employment Functions,266154,1249233962,88003,128473223,6844662,304828,354157,1377707185
0400000US48,48,Texas,,2013,1020,Financial Administration,7254,32586178,226,297077,18115,7357,7480,32883255
0400000US48,48,Texas,,2013,1040,Other Government Administration,2197,9654629,457,466802,27654,2354,2654,10121431
0400000US48,48,Texas,,2013,1060,Judicial and Legal,5523,27875286,140,628042,19036,5630,5663,28503328
0400000US48,48,Texas,,2013,1100,Police Protection Total,6611,33679272,87,94531,7174,6652,6698,33773803
0400000US48,48,Texas,,2013,1101,Police Protection - Persons with Power of Arrest       ,3447,21962127,0,0,0,3447,3447,21962127
0400000US48,48,Texas,,2013,1102,Police Protection - Other ,3164,11717145,87,94531,7174,3205,3251,11811676
0400000US48,48,Texas,,2013,1120,Fire Protection Total ,0,0,0,0,0,0,0,0
0400000US48,48,Texas,,2013,1121,Fire Protection - Firefighters,0,0,0,0,0,0,0,0
0400000US48,48,Texas,,2013,1122,Fire Protection - Other ,0,0,0,0,0,0,0,0
0400000US48,48,Texas,,2013,1140,Corrections,39857,117601047,628,853027,53618,40160,40485,118454074
0400000US48,48,Texas,,2013,1160,Highways,12679,53461158,290,447557,15098,12765,12969,53908715
0400000US48,48,Texas,,2013,1180,Air Transportation,0,0,0,0,0,0,0,0
0400000US48,48,Texas,,2013,1200,Water Transport and Terminals       ,0,0,0,0,0,0,0,0
0400000US48,48,Texas,,2013,1220,Public Welfare,22637,70152042,49,110333,4879,22665,22686,70262375
0400000US48,48,Texas,,2013,1240,Health,18576,81273626,796,2276646,78505,19019,19372,83550272
0400000US48,48,Texas,,2013,1260,Hospitals,23107,106244288,2734,10960993,306908,24841,25841,117205281
0400000US48,48,Texas,,2013,1280,Social Insurance Administration,4269,14989758,34,68216,3057,4287,4303,15057974
0400000US48,48,Texas,,2013,1300,Solid Waste Management,0,0,0,0,0,0,0,0
0400000US48,48,Texas,,2013,1320,Sewerage,0,0,0,0,0,0,0,0
0400000US48,48,Texas,,2013,1340,Parks and Recreation,1114,3507257,120,147342,14149,1194,1234,3654599
0400000US48,48,Texas,,2013,1360,Housing and Community Development,0,0,0,0,0,0,0,0
0400000US48,48,Texas,,2013,1380,Natural Resources,9643,45160139,2563,2806609,156037,10525,12206,47966748
0400000US48,48,Texas,,2013,1400,Water Supply,0,0,0,0,0,0,0,0
0400000US48,48,Texas,,2013,1420,Electric Power,0,0,0,0,0,0,0,0
0400000US48,48,Texas,,2013,1440,Gas Supply,0,0,0,0,0,0,0,0
0400000US48,48,Texas,,2013,1460,Transit,0,0,0,0,0,0,0,0
0400000US48,48,Texas,,2013,1480,Education Total ,105574,622138615,79654,108819023,6117049,140136,185228,730957638
0400000US48,48,Texas,,2013,1481,Education - Elementary and Secondary Total ,16,73427,3,4383,136,17,19,77810
0400000US48,48,Texas,,2013,14811,Education - Elementary and Secondary Instructional             ,14,66609,3,4383,136,15,17,70992
0400000US48,48,Texas,,2013,14812,Education - Elementary and Secondary Other ,2,6818,0,0,0,2,2,6818
0400000US48,48,Texas,,2013,1482,Education - Higher Education Total ,101393,603301648,79329,107857350,6077681,135732,180722,711158998
0400000US48,48,Texas,,2013,14821,Education - Higher Education Instructional,25409,258104171,28829,51525076,2099459,37272,54238,309629247
0400000US48,48,Texas,,2013,14822,Education - Higher Education Other ,75984,345197477,50500,56332274,3978222,98460,126484,401529751
0400000US48,48,Texas,,2013,1483,Education - Other,4165,18763540,322,957290,39232,4387,4487,19720830
0400000US48,48,Texas,,2013,1500,Libraries                          ,0,0,0,0,0,0,0,0
0400000US48,48,Texas,,2013,1560,State liquor stores,0,0,0,0,0,0,0,0
0400000US48,48,Texas,,2013,1580,All other and unallocable,7113,30910667,225,497025,23383,7243,7338,31407692
0400000US49,49,Utah,,2013,1000,Total - All Government Employment Functions,45095,208051840,26228,29578523,1553407,53868,71323,237630363
0400000US49,49,Utah,,2013,1020,Financial Administration,2351,10842235,188,151600,12092,2418,2539,10993835
0400000US49,49,Utah,,2013,1040,Other Government Administration,407,2104160,167,274570,16917,502,574,2378730
0400000US49,49,Utah,,2013,1060,Judicial and Legal,1522,6497228,114,227893,8959,1573,1636,6725121
0400000US49,49,Utah,,2013,1100,Police Protection Total,798,3272478,59,63478,4213,822,857,3335956
0400000US49,49,Utah,,2013,1101,Police Protection - Persons with Power of Arrest       ,394,1877173,0,0,0,394,394,1877173
0400000US49,49,Utah,,2013,1102,Police Protection - Other ,404,1395305,59,63478,4213,428,463,1458783
0400000US49,49,Utah,,2013,1120,Fire Protection Total ,0,0,0,0,0,0,0,0
0400000US49,49,Utah,,2013,1121,Fire Protection - Firefighters,0,0,0,0,0,0,0,0
0400000US49,49,Utah,,2013,1122,Fire Protection - Other ,0,0,0,0,0,0,0,0
0400000US49,49,Utah,,2013,1140,Corrections,2951,10677506,209,188865,14353,3032,3160,10866371
0400000US49,49,Utah,,2013,1160,Highways,1600,6955014,0,0,0,1600,1600,6955014
0400000US49,49,Utah,,2013,1180,Air Transportation,0,0,0,0,0,0,0,0
0400000US49,49,Utah,,2013,1200,Water Transport and Terminals       ,0,0,0,0,0,0,0,0
0400000US49,49,Utah,,2013,1220,Public Welfare,2426,8340800,180,315107,18047,2527,2606,8655907
0400000US49,49,Utah,,2013,1240,Health,1723,7167344,271,502057,25756,1869,1994,7669401
0400000US49,49,Utah,,2013,1260,Hospitals,8144,33775682,1292,2137840,87309,8637,9436,35913522
0400000US49,49,Utah,,2013,1280,Social Insurance Administration,1021,3777250,33,38670,2221,1034,1054,3815920
0400000US49,49,Utah,,2013,1300,Solid Waste Management,0,0,0,0,0,0,0,0
0400000US49,49,Utah,,2013,1320,Sewerage,0,0,0,0,0,0,0,0
0400000US49,49,Utah,,2013,1340,Parks and Recreation,250,803912,54,50851,4401,275,304,854763
0400000US49,49,Utah,,2013,1360,Housing and Community Development,0,0,0,0,0,0,0,0
0400000US49,49,Utah,,2013,1380,Natural Resources,1243,4702817,124,122060,9558,1297,1367,4824877
0400000US49,49,Utah,,2013,1400,Water Supply,0,0,0,0,0,0,0,0
0400000US49,49,Utah,,2013,1420,Electric Power,0,0,0,0,0,0,0,0
0400000US49,49,Utah,,2013,1440,Gas Supply,0,0,0,0,0,0,0,0
0400000US49,49,Utah,,2013,1460,Transit,0,0,0,0,0,0,0,0
0400000US49,49,Utah,,2013,1480,Education Total ,18835,102281266,23186,25308515,1332027,26359,42021,127589781
0400000US49,49,Utah,,2013,1481,Education - Elementary and Secondary Total ,0,0,0,0,0,0,0,0
0400000US49,49,Utah,,2013,14811,Education - Elementary and Secondary Instructional             ,0,0,0,0,0,0,0,0
0400000US49,49,Utah,,2013,14812,Education - Elementary and Secondary Other ,0,0,0,0,0,0,0,0
0400000US49,49,Utah,,2013,1482,Education - Higher Education Total ,17436,96267381,21983,23820789,1247187,24481,39419,120088170
0400000US49,49,Utah,,2013,14821,Education - Higher Education Instructional,5534,47057289,8241,13122835,440024,8020,13775,60180124
0400000US49,49,Utah,,2013,14822,Education - Higher Education Other ,11902,49210092,13742,10697954,807163,16461,25644,59908046
0400000US49,49,Utah,,2013,1483,Education - Other,1399,6013885,1203,1487726,84840,1878,2602,7501611
0400000US49,49,Utah,,2013,1500,Libraries                          ,0,0,0,0,0,0,0,0
0400000US49,49,Utah,,2013,1560,State liquor stores,255,682655,306,183093,16999,351,561,865748
0400000US49,49,Utah,,2013,1580,All other and unallocable,1569,6171493,45,13924,555,1572,1614,6185417
0400000US50,50,Vermont,,2013,1000,Total - All Government Employment Functions,13366,64416932,3746,5898097,163079,14314,17112,70315029
0400000US50,50,Vermont,,2013,1020,Financial Administration,610,2833310,14,12682,740,614,624,2845992
0400000US50,50,Vermont,,2013,1040,Other Government Administration,498,2036191,213,545516,2280,510,711,2581707
0400000US50,50,Vermont,,2013,1060,Judicial and Legal,675,3211598,22,14300,720,679,697,3225898
0400000US50,50,Vermont,,2013,1100,Police Protection Total,622,3208540,53,34270,1722,632,675,3242810
0400000US50,50,Vermont,,2013,1101,Police Protection - Persons with Power of Arrest       ,288,1771329,11,11700,385,290,299,1783029
0400000US50,50,Vermont,,2013,1102,Police Protection - Other ,334,1437211,42,22570,1337,342,376,1459781
0400000US50,50,Vermont,,2013,1120,Fire Protection Total ,0,0,0,0,0,0,0,0
0400000US50,50,Vermont,,2013,1121,Fire Protection - Firefighters,0,0,0,0,0,0,0,0
0400000US50,50,Vermont,,2013,1122,Fire Protection - Other ,0,0,0,0,0,0,0,0
0400000US50,50,Vermont,,2013,1140,Corrections,1100,4669189,7,4132,239,1101,1107,4673321
0400000US50,50,Vermont,,2013,1160,Highways,1058,4819486,4,1364,71,1058,1062,4820850
0400000US50,50,Vermont,,2013,1180,Air Transportation,0,0,0,0,0,0,0,0
0400000US50,50,Vermont,,2013,1200,Water Transport and Terminals       ,0,0,0,0,0,0,0,0
0400000US50,50,Vermont,,2013,1220,Public Welfare,1402,6096159,29,30745,1114,1408,1431,6126904
0400000US50,50,Vermont,,2013,1240,Health,487,2209625,40,15438,1065,493,527,2225063
0400000US50,50,Vermont,,2013,1260,Hospitals,175,845126,9,8797,208,176,184,853923
0400000US50,50,Vermont,,2013,1280,Social Insurance Administration,274,1140966,6,3738,188,275,280,1144704
0400000US50,50,Vermont,,2013,1300,Solid Waste Management,0,0,0,0,0,0,0,0
0400000US50,50,Vermont,,2013,1320,Sewerage,0,0,0,0,0,0,0,0
0400000US50,50,Vermont,,2013,1340,Parks and Recreation,114,505484,3,1182,89,115,117,506666
0400000US50,50,Vermont,,2013,1360,Housing and Community Development,0,0,0,0,0,0,0,0
0400000US50,50,Vermont,,2013,1380,Natural Resources,568,2743496,14,18835,764,572,582,2762331
0400000US50,50,Vermont,,2013,1400,Water Supply,0,0,0,0,0,0,0,0
0400000US50,50,Vermont,,2013,1420,Electric Power,0,0,0,0,0,0,0,0
0400000US50,50,Vermont,,2013,1440,Gas Supply,0,0,0,0,0,0,0,0
0400000US50,50,Vermont,,2013,1460,Transit,0,0,0,0,0,0,0,0
0400000US50,50,Vermont,,2013,1480,Education Total ,4566,24434449,3269,5144364,150459,5447,7835,29578813
0400000US50,50,Vermont,,2013,1481,Education - Elementary and Secondary Total ,0,0,0,0,0,0,0,0
0400000US50,50,Vermont,,2013,14811,Education - Elementary and Secondary Instructional             ,0,0,0,0,0,0,0,0
0400000US50,50,Vermont,,2013,14812,Education - Elementary and Secondary Other ,0,0,0,0,0,0,0,0
0400000US50,50,Vermont,,2013,1482,Education - Higher Education Total ,4128,22381953,3249,5109808,148917,5000,7377,27491761
0400000US50,50,Vermont,,2013,14821,Education - Higher Education Instructional,1059,9038814,1256,2443686,39926,1290,2315,11482500
0400000US50,50,Vermont,,2013,14822,Education - Higher Education Other ,3069,13343139,1993,2666122,108991,3710,5062,16009261
0400000US50,50,Vermont,,2013,1483,Education - Other,438,2052496,20,34556,1542,447,458,2087052
0400000US50,50,Vermont,,2013,1500,Libraries                          ,0,0,0,0,0,0,0,0
0400000US50,50,Vermont,,2013,1560,State liquor stores,52,239282,1,624,58,52,53,239906
0400000US50,50,Vermont,,2013,1580,All other and unallocable,1165,5424031,62,62110,3362,1182,1227,5486141
0400000US51,51,Virginia,,2013,1000,Total - All Government Employment Functions,106250,483795887,56632,67526173,3358787,125234,162882,551322060
0400000US51,51,Virginia,,2013,1020,Financial Administration,3889,17113400,516,815608,55792,4204,4405,17929008
0400000US51,51,Virginia,,2013,1040,Other Government Administration,517,2943867,257,573981,23556,655,774,3517848
0400000US51,51,Virginia,,2013,1060,Judicial and Legal,3685,17437724,332,388588,12674,3757,4017,17826312
0400000US51,51,Virginia,,2013,1100,Police Protection Total,3073,14267862,137,270096,13304,3148,3210,14537958
0400000US51,51,Virginia,,2013,1101,Police Protection - Persons with Power of Arrest       ,2306,11567127,12,23610,1198,2313,2318,11590737
0400000US51,51,Virginia,,2013,1102,Police Protection - Other ,767,2700735,125,246486,12106,835,892,2947221
0400000US51,51,Virginia,,2013,1120,Fire Protection Total ,0,0,0,0,0,0,0,0
0400000US51,51,Virginia,,2013,1121,Fire Protection - Firefighters,0,0,0,0,0,0,0,0
0400000US51,51,Virginia,,2013,1122,Fire Protection - Other ,0,0,0,0,0,0,0,0
0400000US51,51,Virginia,,2013,1140,Corrections,13286,42221384,328,509496,32308,13469,13614,42730880
0400000US51,51,Virginia,,2013,1160,Highways,7129,32506104,263,420186,19726,7240,7392,32926290
0400000US51,51,Virginia,,2013,1180,Air Transportation,0,0,0,0,0,0,0,0
0400000US51,51,Virginia,,2013,1200,Water Transport and Terminals       ,80,516336,2,3330,266,82,82,519666
0400000US51,51,Virginia,,2013,1220,Public Welfare,2676,11374294,336,574845,28874,2839,3012,11949139
0400000US51,51,Virginia,,2013,1240,Health,5033,20495204,702,1037146,62004,5383,5735,21532350
0400000US51,51,Virginia,,2013,1260,Hospitals,13204,52621044,2452,4622947,168131,14154,15656,57243991
0400000US51,51,Virginia,,2013,1280,Social Insurance Administration,1198,4533308,510,910416,53022,1498,1708,5443724
0400000US51,51,Virginia,,2013,1300,Solid Waste Management,0,0,0,0,0,0,0,0
0400000US51,51,Virginia,,2013,1320,Sewerage,0,0,0,0,0,0,0,0
0400000US51,51,Virginia,,2013,1340,Parks and Recreation,653,2387174,921,784386,68642,1040,1574,3171560
0400000US51,51,Virginia,,2013,1360,Housing and Community Development,0,0,0,0,0,0,0,0
0400000US51,51,Virginia,,2013,1380,Natural Resources,2301,11124788,593,949856,63709,2662,2894,12074644
0400000US51,51,Virginia,,2013,1400,Water Supply,0,0,0,0,0,0,0,0
0400000US51,51,Virginia,,2013,1420,Electric Power,0,0,0,0,0,0,0,0
0400000US51,51,Virginia,,2013,1440,Gas Supply,0,0,0,0,0,0,0,0
0400000US51,51,Virginia,,2013,1460,Transit,0,0,0,0,0,0,0,0
0400000US51,51,Virginia,,2013,1480,Education Total ,45077,233048654,46685,52860157,2536213,59409,91762,285908811
0400000US51,51,Virginia,,2013,1481,Education - Elementary and Secondary Total ,0,0,0,0,0,0,0,0
0400000US51,51,Virginia,,2013,14811,Education - Elementary and Secondary Instructional             ,0,0,0,0,0,0,0,0
0400000US51,51,Virginia,,2013,14812,Education - Elementary and Secondary Other ,0,0,0,0,0,0,0,0
0400000US51,51,Virginia,,2013,1482,Education - Higher Education Total ,42684,221483412,46181,52074405,2495567,56785,88865,273557817
0400000US51,51,Virginia,,2013,14821,Education - Higher Education Instructional,14905,112167977,16254,26222329,718800,18965,31159,138390306
0400000US51,51,Virginia,,2013,14822,Education - Higher Education Other ,27779,109315435,29927,25852076,1776767,37820,57706,135167511
0400000US51,51,Virginia,,2013,1483,Education - Other,2393,11565242,504,785752,40646,2624,2897,12350994
0400000US51,51,Virginia,,2013,1500,Libraries                          ,0,0,0,0,0,0,0,0
0400000US51,51,Virginia,,2013,1560,State liquor stores,847,3098298,1757,1956152,180012,1864,2604,5054450
0400000US51,51,Virginia,,2013,1580,All other and unallocable,3602,18106446,841,848983,40554,3830,4443,18955429
0400000US53,53,Washington,,2013,1000,Total - All Government Employment Functions,94091,470362327,57943,102641376,4217276,117911,152034,573003703
0400000US53,53,Washington,,2013,1020,Financial Administration,2606,13103150,209,738448,24374,2743,2815,13841598
0400000US53,53,Washington,,2013,1040,Other Government Administration,891,4242452,882,2657546,88786,1392,1773,6899998
0400000US53,53,Washington,,2013,1060,Judicial and Legal,1798,10033290,199,813190,24998,1938,1997,10846480
0400000US53,53,Washington,,2013,1100,Police Protection Total,2168,11507506,41,143854,2574,2183,2209,11651360
0400000US53,53,Washington,,2013,1101,Police Protection - Persons with Power of Arrest       ,801,5731532,0,0,0,801,801,5731532
0400000US53,53,Washington,,2013,1102,Police Protection - Other ,1367,5775974,41,143854,2574,1382,1408,5919828
0400000US53,53,Washington,,2013,1120,Fire Protection Total ,0,0,0,0,0,0,0,0
0400000US53,53,Washington,,2013,1121,Fire Protection - Firefighters,0,0,0,0,0,0,0,0
0400000US53,53,Washington,,2013,1122,Fire Protection - Other ,0,0,0,0,0,0,0,0
0400000US53,53,Washington,,2013,1140,Corrections,6717,28391718,2100,7315010,293716,8376,8817,35706728
0400000US53,53,Washington,,2013,1160,Highways,6755,34672966,171,397032,9178,6807,6926,35069998
0400000US53,53,Washington,,2013,1180,Air Transportation,0,0,0,0,0,0,0,0
0400000US53,53,Washington,,2013,1200,Water Transport and Terminals       ,2,9864,0,0,0,2,2,9864
0400000US53,53,Washington,,2013,1220,Public Welfare,8307,36058194,1824,6130710,230702,9610,10131,42188904
0400000US53,53,Washington,,2013,1240,Health,5126,21811868,1753,5504620,227464,6411,6879,27316488
0400000US53,53,Washington,,2013,1260,Hospitals,7911,43769532,3663,14717611,335938,9808,11574,58487143
0400000US53,53,Washington,,2013,1280,Social Insurance Administration,3417,15159138,1320,2634882,129426,4149,4737,17794020
0400000US53,53,Washington,,2013,1300,Solid Waste Management,391,2109442,154,679720,21178,511,545,2789162
0400000US53,53,Washington,,2013,1320,Sewerage,0,0,0,0,0,0,0,0
0400000US53,53,Washington,,2013,1340,Parks and Recreation,330,1522794,239,903934,33582,520,569,2426728
0400000US53,53,Washington,,2013,1360,Housing and Community Development,56,311956,8,19872,738,60,64,331828
0400000US53,53,Washington,,2013,1380,Natural Resources,3905,17652380,1648,4208284,158246,4798,5553,21860664
0400000US53,53,Washington,,2013,1400,Water Supply,0,0,0,0,0,0,0,0
0400000US53,53,Washington,,2013,1420,Electric Power,0,0,0,0,0,0,0,0
0400000US53,53,Washington,,2013,1440,Gas Supply,0,0,0,0,0,0,0,0
0400000US53,53,Washington,,2013,1460,Transit,0,0,0,0,0,0,0,0
0400000US53,53,Washington,,2013,1480,Education Total ,40335,213733619,42891,52671515,2530410,54628,83226,266405134
0400000US53,53,Washington,,2013,1481,Education - Elementary and Secondary Total ,0,0,0,0,0,0,0,0
0400000US53,53,Washington,,2013,14811,Education - Elementary and Secondary Instructional             ,0,0,0,0,0,0,0,0
0400000US53,53,Washington,,2013,14812,Education - Elementary and Secondary Other ,0,0,0,0,0,0,0,0
0400000US53,53,Washington,,2013,1482,Education - Higher Education Total ,38805,206704655,41972,50568855,2455714,52676,80777,257273510
0400000US53,53,Washington,,2013,14821,Education - Higher Education Instructional,12920,89245099,9731,21827302,479122,15627,22651,111072401
0400000US53,53,Washington,,2013,14822,Education - Higher Education Other ,25885,117459556,32241,28741553,1976592,37049,58126,146201109
0400000US53,53,Washington,,2013,1483,Education - Other,1530,7028964,919,2102660,74696,1952,2449,9131624
0400000US53,53,Washington,,2013,1500,Libraries                          ,0,0,0,0,0,0,0,0
0400000US53,53,Washington,,2013,1560,State liquor stores,81,420454,12,43754,1382,89,93,464208
0400000US53,53,Washington,,2013,1580,All other and unallocable,3295,15852004,829,3061394,104584,3886,4124,18913398
0400000US54,54,West Virginia,,2013,1000,Total - All Government Employment Functions,37235,138069187,12347,11661494,651183,41120,49582,149730681
0400000US54,54,West Virginia,,2013,1020,Financial Administration,1934,5770360,56,69248,3606,1955,1990,5839608
0400000US54,54,West Virginia,,2013,1040,Other Government Administration,219,810152,285,785336,26099,376,504,1595488
0400000US54,54,West Virginia,,2013,1060,Judicial and Legal,1570,7290916,49,87249,4403,1596,1619,7378165
0400000US54,54,West Virginia,,2013,1100,Police Protection Total,1036,4269808,20,17526,1378,1044,1056,4287334
0400000US54,54,West Virginia,,2013,1101,Police Protection - Persons with Power of Arrest       ,658,3301590,0,0,0,658,658,3301590
0400000US54,54,West Virginia,,2013,1102,Police Protection - Other ,378,968218,20,17526,1378,386,398,985744
0400000US54,54,West Virginia,,2013,1120,Fire Protection Total ,0,0,0,0,0,0,0,0
0400000US54,54,West Virginia,,2013,1121,Fire Protection - Firefighters,0,0,0,0,0,0,0,0
0400000US54,54,West Virginia,,2013,1122,Fire Protection - Other ,0,0,0,0,0,0,0,0
0400000US54,54,West Virginia,,2013,1140,Corrections,3640,9468002,5,7286,608,3644,3645,9475288
0400000US54,54,West Virginia,,2013,1160,Highways,5290,16917650,27,40918,4327,5314,5317,16958568
0400000US54,54,West Virginia,,2013,1180,Air Transportation,3,12118,0,0,0,3,3,12118
0400000US54,54,West Virginia,,2013,1200,Water Transport and Terminals       ,3,12888,0,0,0,3,3,12888
0400000US54,54,West Virginia,,2013,1220,Public Welfare,3430,9021877,50,60458,4640,3458,3480,9082335
0400000US54,54,West Virginia,,2013,1240,Health,818,2726778,53,75612,3598,839,871,2802390
0400000US54,54,West Virginia,,2013,1260,Hospitals,1727,4609848,78,82860,6694,1767,1805,4692708
0400000US54,54,West Virginia,,2013,1280,Social Insurance Administration,564,1708562,90,93626,7270,607,654,1802188
0400000US54,54,West Virginia,,2013,1300,Solid Waste Management,11,42518,0,0,0,11,11,42518
0400000US54,54,West Virginia,,2013,1320,Sewerage,0,0,0,0,0,0,0,0
0400000US54,54,West Virginia,,2013,1340,Parks and Recreation,405,854722,412,329520,42484,645,817,1184242
0400000US54,54,West Virginia,,2013,1360,Housing and Community Development,0,0,0,0,0,0,0,0
0400000US54,54,West Virginia,,2013,1380,Natural Resources,1856,6668831,138,115278,10055,1913,1994,6784109
0400000US54,54,West Virginia,,2013,1400,Water Supply,0,0,0,0,0,0,0,0
0400000US54,54,West Virginia,,2013,1420,Electric Power,0,0,0,0,0,0,0,0
0400000US54,54,West Virginia,,2013,1440,Gas Supply,0,0,0,0,0,0,0,0
0400000US54,54,West Virginia,,2013,1460,Transit,9,32234,0,0,0,9,9,32234
0400000US54,54,West Virginia,,2013,1480,Education Total ,12330,59774412,10912,9778090,528331,15501,23242,69552502
0400000US54,54,West Virginia,,2013,1481,Education - Elementary and Secondary Total ,0,0,0,0,0,0,0,0
0400000US54,54,West Virginia,,2013,14811,Education - Elementary and Secondary Instructional             ,0,0,0,0,0,0,0,0
0400000US54,54,West Virginia,,2013,14812,Education - Elementary and Secondary Other ,0,0,0,0,0,0,0,0
0400000US54,54,West Virginia,,2013,1482,Education - Higher Education Total ,11037,54514818,10765,9572746,522311,14172,21802,64087564
0400000US54,54,West Virginia,,2013,14821,Education - Higher Education Instructional,3784,25322231,4542,6077611,188677,4914,8326,31399842
0400000US54,54,West Virginia,,2013,14822,Education - Higher Education Other ,7253,29192587,6223,3495135,333634,9258,13476,32687722
0400000US54,54,West Virginia,,2013,1483,Education - Other,1293,5259594,147,205344,6020,1329,1440,5464938
0400000US54,54,West Virginia,,2013,1500,Libraries                          ,0,0,0,0,0,0,0,0
0400000US54,54,West Virginia,,2013,1560,State liquor stores,49,133212,2,3252,270,51,51,136464
0400000US54,54,West Virginia,,2013,1580,All other and unallocable,2341,7944299,170,115235,7420,2384,2511,8059534
0400000US55,55,Wisconsin,,2013,1000,Total - All Government Employment Functions,56460,282313430,50110,50912921,2811648,72347,106570,333226351
0400000US55,55,Wisconsin,,2013,1020,Financial Administration,2109,10197175,338,666757,41213,2342,2447,10863932
0400000US55,55,Wisconsin,,2013,1040,Other Government Administration,507,2331142,255,672987,30728,682,762,3004129
0400000US55,55,Wisconsin,,2013,1060,Judicial and Legal,2099,13022995,291,820909,28872,2263,2390,13843904
0400000US55,55,Wisconsin,,2013,1100,Police Protection Total,734,3754080,38,87475,4242,759,772,3841555
0400000US55,55,Wisconsin,,2013,1101,Police Protection - Persons with Power of Arrest       ,541,2920240,12,34370,1302,549,553,2954610
0400000US55,55,Wisconsin,,2013,1102,Police Protection - Other ,193,833840,26,53105,2940,210,219,886945
0400000US55,55,Wisconsin,,2013,1120,Fire Protection Total ,0,0,0,0,0,0,0,0
0400000US55,55,Wisconsin,,2013,1121,Fire Protection - Firefighters,0,0,0,0,0,0,0,0
0400000US55,55,Wisconsin,,2013,1122,Fire Protection - Other ,0,0,0,0,0,0,0,0
0400000US55,55,Wisconsin,,2013,1140,Corrections,9252,38574815,627,2315691,73536,9667,9879,40890506
0400000US55,55,Wisconsin,,2013,1160,Highways,1346,7087273,70,159041,6809,1384,1416,7246314
0400000US55,55,Wisconsin,,2013,1180,Air Transportation,0,0,0,0,0,0,0,0
0400000US55,55,Wisconsin,,2013,1200,Water Transport and Terminals       ,0,0,0,0,0,0,0,0
0400000US55,55,Wisconsin,,2013,1220,Public Welfare,1798,7835688,371,901569,55882,2113,2169,8737257
0400000US55,55,Wisconsin,,2013,1240,Health,1339,6585496,409,941446,39290,1561,1748,7526942
0400000US55,55,Wisconsin,,2013,1260,Hospitals,3280,12718226,504,1612653,54049,3585,3784,14330879
0400000US55,55,Wisconsin,,2013,1280,Social Insurance Administration,908,3723228,46,112226,5396,938,954,3835454
0400000US55,55,Wisconsin,,2013,1300,Solid Waste Management,0,0,0,0,0,0,0,0
0400000US55,55,Wisconsin,,2013,1320,Sewerage,0,0,0,0,0,0,0,0
0400000US55,55,Wisconsin,,2013,1340,Parks and Recreation,108,448320,65,77088,4400,133,173,525408
0400000US55,55,Wisconsin,,2013,1360,Housing and Community Development,0,0,0,0,0,0,0,0
0400000US55,55,Wisconsin,,2013,1380,Natural Resources,1731,7511851,903,1096290,55583,2045,2634,8608141
0400000US55,55,Wisconsin,,2013,1400,Water Supply,0,0,0,0,0,0,0,0
0400000US55,55,Wisconsin,,2013,1420,Electric Power,0,0,0,0,0,0,0,0
0400000US55,55,Wisconsin,,2013,1440,Gas Supply,0,0,0,0,0,0,0,0
0400000US55,55,Wisconsin,,2013,1460,Transit,0,0,0,0,0,0,0,0
0400000US55,55,Wisconsin,,2013,1480,Education Total ,26809,146245775,45330,39664187,2334381,39998,72139,185909962
0400000US55,55,Wisconsin,,2013,1481,Education - Elementary and Secondary Total ,0,0,0,0,0,0,0,0
0400000US55,55,Wisconsin,,2013,14811,Education - Elementary and Secondary Instructional             ,0,0,0,0,0,0,0,0
0400000US55,55,Wisconsin,,2013,14812,Education - Elementary and Secondary Other ,0,0,0,0,0,0,0,0
0400000US55,55,Wisconsin,,2013,1482,Education - Higher Education Total ,25926,142018301,45010,38883204,2298478,38912,70936,180901505
0400000US55,55,Wisconsin,,2013,14821,Education - Higher Education Instructional,8765,59235982,12274,14358226,704308,12744,21039,73594208
0400000US55,55,Wisconsin,,2013,14822,Education - Higher Education Other ,17161,82782319,32736,24524978,1594170,26168,49897,107307297
0400000US55,55,Wisconsin,,2013,1483,Education - Other,883,4227474,320,780983,35903,1086,1203,5008457
0400000US55,55,Wisconsin,,2013,1500,Libraries                          ,0,0,0,0,0,0,0,0
0400000US55,55,Wisconsin,,2013,1560,State liquor stores,0,0,0,0,0,0,0,0
0400000US55,55,Wisconsin,,2013,1580,All other and unallocable,4440,22277366,863,1784602,77267,4877,5303,24061968
0400000US56,56,Wyoming,,2013,1000,Total - All Government Employment Functions,12311,53741536,3292,2779401,183896,13344,15603,56520937
0400000US56,56,Wyoming,,2013,1020,Financial Administration,692,3442056,5,11392,456,694,697,3453448
0400000US56,56,Wyoming,,2013,1040,Other Government Administration,138,771468,92,134110,7594,180,230,905578
0400000US56,56,Wyoming,,2013,1060,Judicial and Legal,529,2871308,30,99320,2782,544,559,2970628
0400000US56,56,Wyoming,,2013,1100,Police Protection Total,292,1396218,0,0,0,292,292,1396218
0400000US56,56,Wyoming,,2013,1101,Police Protection - Persons with Power of Arrest       ,199,880513,0,0,0,199,199,880513
0400000US56,56,Wyoming,,2013,1102,Police Protection - Other ,93,515705,0,0,0,93,93,515705
0400000US56,56,Wyoming,,2013,1120,Fire Protection Total ,0,0,0,0,0,0,0,0
0400000US56,56,Wyoming,,2013,1121,Fire Protection - Firefighters,0,0,0,0,0,0,0,0
0400000US56,56,Wyoming,,2013,1122,Fire Protection - Other ,0,0,0,0,0,0,0,0
0400000US56,56,Wyoming,,2013,1140,Corrections,1340,4873458,1,1360,88,1340,1341,4874818
0400000US56,56,Wyoming,,2013,1160,Highways,1793,7217018,11,15395,972,1798,1804,7232413
0400000US56,56,Wyoming,,2013,1180,Air Transportation,0,0,0,0,0,0,0,0
0400000US56,56,Wyoming,,2013,1200,Water Transport and Terminals       ,0,0,0,0,0,0,0,0
0400000US56,56,Wyoming,,2013,1220,Public Welfare,568,2518017,1,1360,88,568,569,2519377
0400000US56,56,Wyoming,,2013,1240,Health,882,3948552,65,112983,6457,919,947,4061535
0400000US56,56,Wyoming,,2013,1260,Hospitals,720,2429628,12,24545,949,726,732,2454173
0400000US56,56,Wyoming,,2013,1280,Social Insurance Administration,124,472764,0,0,0,124,124,472764
0400000US56,56,Wyoming,,2013,1300,Solid Waste Management,0,0,0,0,0,0,0,0
0400000US56,56,Wyoming,,2013,1320,Sewerage,0,0,0,0,0,0,0,0
0400000US56,56,Wyoming,,2013,1340,Parks and Recreation,162,703082,6,10874,530,165,168,713956
0400000US56,56,Wyoming,,2013,1360,Housing and Community Development,0,0,0,0,0,0,0,0
0400000US56,56,Wyoming,,2013,1380,Natural Resources,820,3888043,11,17865,1095,826,831,3905908
0400000US56,56,Wyoming,,2013,1400,Water Supply,0,0,0,0,0,0,0,0
0400000US56,56,Wyoming,,2013,1420,Electric Power,0,0,0,0,0,0,0,0
0400000US56,56,Wyoming,,2013,1440,Gas Supply,0,0,0,0,0,0,0,0
0400000US56,56,Wyoming,,2013,1460,Transit,0,0,0,0,0,0,0,0
0400000US56,56,Wyoming,,2013,1480,Education Total ,3325,15292253,3029,2309732,160292,4230,6354,17601985
0400000US56,56,Wyoming,,2013,1481,Education - Elementary and Secondary Total ,0,0,0,0,0,0,0,0
0400000US56,56,Wyoming,,2013,14811,Education - Elementary and Secondary Instructional             ,0,0,0,0,0,0,0,0
0400000US56,56,Wyoming,,2013,14812,Education - Elementary and Secondary Other ,0,0,0,0,0,0,0,0
0400000US56,56,Wyoming,,2013,1482,Education - Higher Education Total ,3114,14224662,3026,2305899,160027,4018,6140,16530561
0400000US56,56,Wyoming,,2013,14821,Education - Higher Education Instructional,1063,6827321,787,1011685,48693,1338,1850,7839006
0400000US56,56,Wyoming,,2013,14822,Education - Higher Education Other ,2051,7397341,2239,1294214,111334,2680,4290,8691555
0400000US56,56,Wyoming,,2013,1483,Education - Other,211,1067591,3,3833,265,212,214,1071424
0400000US56,56,Wyoming,,2013,1500,Libraries                          ,0,0,0,0,0,0,0,0
0400000US56,56,Wyoming,,2013,1560,State liquor stores,38,143704,0,0,0,38,38,143704
0400000US56,56,Wyoming,,2013,1580,All other and unallocable,888,3773967,29,40465,2593,900,917,3814432
