GEO.id,GEO.id2,GEO.display-label,GEO.annotation.id,YEAR.id,GOVEMPFUNCT.id,GOVEMPFUNCT.display-label,EMPFT,PAYANNFT,EMPPT,PAYANNPT,HRSPT,EMPFTE,EMP,PAYANN
0100000US,,United States,,2015,1000,Total - All Government Employment Functions,3750210,19351244811,1593343,2217198905,102550874,4338661,5343553,21568443716
0100000US,,United States,,2015,1020,Financial Administration,165458,807520310,10123,21495320,1057868,171529,175581,829015630
0100000US,,United States,,2015,1040,Other Government Administration,47232,233053912,10322,22600660,966291,52809,57554,255654572
0100000US,,United States,,2015,1060,Judicial and Legal,169635,952136173,8731,20889781,796834,174180,178366,973025954
0100000US,,United States,,2015,1100,Police Protection Total,100877,603969707,2822,4560350,179569,101905,103699,608530057
0100000US,,United States,,2015,1101,Police Protection - Persons with Power of Arrest       ,64833,449736454,532,664873,22055,64957,65365,450401327
0100000US,,United States,,2015,1102,Police Protection - Other ,36044,154233253,2290,3895477,157514,36948,38334,158128730
0100000US,,United States,,2015,1120,Fire Protection Total ,0,0,0,0,0,0,0,0
0100000US,,United States,,2015,1121,Fire Protection - Firefighters,0,0,0,0,0,0,0,0
0100000US,,United States,,2015,1122,Fire Protection - Other ,0,0,0,0,0,0,0,0
0100000US,,United States,,2015,1140,Corrections,433012,1964638804,8749,23694207,911183,438204,441761,1988333011
0100000US,,United States,,2015,1160,Highways,207143,1014546296,11674,28177716,1106216,213551,218817,1042724012
0100000US,,United States,,2015,1180,Air Transportation,3235,18231407,65,129417,4839,3263,3300,18360824
0100000US,,United States,,2015,1200,Water Transport and Terminals       ,4482,26789857,74,139943,7015,4521,4556,26929800
0100000US,,United States,,2015,1220,Public Welfare,235386,944077468,11216,26339542,1236690,242456,246602,970417010
0100000US,,United States,,2015,1240,Health,176475,827143592,16090,37801812,1357780,184212,192565,864945404
0100000US,,United States,,2015,1260,Hospitals,345069,1678679486,75806,284845396,7664565,388743,420875,1963524882
0100000US,,United States,,2015,1280,Social Insurance Administration,70177,313835629,4637,11918016,521505,73161,74814,325753645
0100000US,,United States,,2015,1300,Solid Waste Management,2300,13488506,193,508433,21554,2422,2493,13996939
0100000US,,United States,,2015,1320,Sewerage,1663,10719076,48,240881,3935,1686,1711,10959957
0100000US,,United States,,2015,1340,Parks and Recreation,30031,111249571,10820,14404246,999409,35778,40851,125653817
0100000US,,United States,,2015,1360,Housing and Community Development,613,3501708,56,133542,6516,650,669,3635250
0100000US,,United States,,2015,1380,Natural Resources,120754,568154817,25971,41038012,2226427,133414,146725,609192829
0100000US,,United States,,2015,1400,Water Supply,782,4184258,31,57500,1598,791,813,4241758
0100000US,,United States,,2015,1420,Electric Power,4083,29572850,68,181192,5356,4114,4151,29754042
0100000US,,United States,,2015,1440,Gas Supply,0,0,0,0,0,0,0,0
0100000US,,United States,,2015,1460,Transit,32133,208674867,1431,2689922,130158,32869,33564,211364789
0100000US,,United States,,2015,1480,Education Total ,1425964,8148474249,1374656,1642277584,81817112,1895865,2800620,9790751833
0100000US,,United States,,2015,1481,Education - Elementary and Secondary Total ,42580,217660613,17233,20298937,1080572,49221,59813,237959550
0100000US,,United States,,2015,14811,Education - Elementary and Secondary Instructional             ,31853,177797121,12117,13631156,701109,36105,43970,191428277
0100000US,,United States,,2015,14812,Education - Elementary and Secondary Other ,10727,39863492,5116,6667781,379463,13116,15843,46531273
0100000US,,United States,,2015,1482,Education - Higher Education Total ,1304789,7560158701,1344794,1599610896,79727058,1762271,2649583,9159769597
0100000US,,United States,,2015,14821,Education - Higher Education Instructional,420483,3330450154,432506,795014960,27899524,580840,852989,4125465114
0100000US,,United States,,2015,14822,Education - Higher Education Other ,884306,4229708547,912288,804595936,51827534,1181431,1796594,5034304483
0100000US,,United States,,2015,1483,Education - Other,78595,370654935,12629,22367751,1009482,84373,91224,393022686
0100000US,,United States,,2015,1500,Libraries                          ,533,1969176,248,213962,18083,635,781,2183138
0100000US,,United States,,2015,1560,State liquor stores,6133,21315726,6174,8192728,503070,9089,12307,29508454
0100000US,,United States,,2015,1580,All other and unallocable,167040,845317366,13338,24668743,1007301,172814,180378,869986109
0400000US01,01,Alabama,,2015,1000,Total - All Government Employment Functions,78744,354395574,30953,32168951,1853566,89448,109697,386564525
0400000US01,01,Alabama,,2015,1020,Financial Administration,2431,10789108,72,89025,6784,2470,2503,10878133
0400000US01,01,Alabama,,2015,1040,Other Government Administration,493,2424610,218,655735,20500,609,711,3080345
0400000US01,01,Alabama,,2015,1060,Judicial and Legal,3021,14735347,266,421014,28261,3180,3287,15156361
0400000US01,01,Alabama,,2015,1100,Police Protection Total,1324,5155152,0,0,0,1324,1324,5155152
0400000US01,01,Alabama,,2015,1101,Police Protection - Persons with Power of Arrest       ,754,3414294,0,0,0,754,754,3414294
0400000US01,01,Alabama,,2015,1102,Police Protection - Other ,570,1740858,0,0,0,570,570,1740858
0400000US01,01,Alabama,,2015,1120,Fire Protection Total ,0,0,0,0,0,0,0,0
0400000US01,01,Alabama,,2015,1121,Fire Protection - Firefighters,0,0,0,0,0,0,0,0
0400000US01,01,Alabama,,2015,1122,Fire Protection - Other ,0,0,0,0,0,0,0,0
0400000US01,01,Alabama,,2015,1140,Corrections,4743,18195881,130,296140,12954,4816,4873,18492021
0400000US01,01,Alabama,,2015,1160,Highways,4285,15296648,57,43324,4466,4310,4342,15339972
0400000US01,01,Alabama,,2015,1180,Air Transportation,0,0,0,0,0,0,0,0
0400000US01,01,Alabama,,2015,1200,Water Transport and Terminals       ,587,2854808,3,2255,127,587,590,2857063
0400000US01,01,Alabama,,2015,1220,Public Welfare,3908,13660784,93,161368,7974,3953,4001,13822152
0400000US01,01,Alabama,,2015,1240,Health,4216,16707298,319,336826,18066,4319,4535,17044124
0400000US01,01,Alabama,,2015,1260,Hospitals,11291,49831804,1668,3724155,129419,12059,12959,53555959
0400000US01,01,Alabama,,2015,1280,Social Insurance Administration,915,3311954,36,39770,3920,937,951,3351724
0400000US01,01,Alabama,,2015,1300,Solid Waste Management,0,0,0,0,0,0,0,0
0400000US01,01,Alabama,,2015,1320,Sewerage,0,0,0,0,0,0,0,0
0400000US01,01,Alabama,,2015,1340,Parks and Recreation,330,878720,291,303122,35116,528,621,1181842
0400000US01,01,Alabama,,2015,1360,Housing and Community Development,0,0,0,0,0,0,0,0
0400000US01,01,Alabama,,2015,1380,Natural Resources,1823,6769522,122,132310,8845,1873,1945,6901832
0400000US01,01,Alabama,,2015,1400,Water Supply,0,0,0,0,0,0,0,0
0400000US01,01,Alabama,,2015,1420,Electric Power,0,0,0,0,0,0,0,0
0400000US01,01,Alabama,,2015,1440,Gas Supply,0,0,0,0,0,0,0,0
0400000US01,01,Alabama,,2015,1460,Transit,0,0,0,0,0,0,0,0
0400000US01,01,Alabama,,2015,1480,Education Total ,36607,183253421,27109,25298354,1529363,45446,63716,208551775
0400000US01,01,Alabama,,2015,1481,Education - Elementary and Secondary Total ,0,0,0,0,0,0,0,0
0400000US01,01,Alabama,,2015,14811,Education - Elementary and Secondary Instructional             ,0,0,0,0,0,0,0,0
0400000US01,01,Alabama,,2015,14812,Education - Elementary and Secondary Other ,0,0,0,0,0,0,0,0
0400000US01,01,Alabama,,2015,1482,Education - Higher Education Total ,33702,171753575,26940,25095882,1514684,42460,60642,196849457
0400000US01,01,Alabama,,2015,14821,Education - Higher Education Instructional,10036,76453720,8729,11177708,464649,12716,18765,87631428
0400000US01,01,Alabama,,2015,14822,Education - Higher Education Other ,23666,95299855,18211,13918174,1050035,29744,41877,109218029
0400000US01,01,Alabama,,2015,1483,Education - Other,2905,11499846,169,202472,14679,2986,3074,11702318
0400000US01,01,Alabama,,2015,1500,Libraries                          ,0,0,0,0,0,0,0,0
0400000US01,01,Alabama,,2015,1560,State liquor stores,755,2058456,15,27408,1482,763,770,2085864
0400000US01,01,Alabama,,2015,1580,All other and unallocable,2015,8472061,554,638145,46289,2274,2569,9110206
0400000US02,02,Alaska,,2015,1000,Total - All Government Employment Functions,24234,138194341,5087,6517057,332865,26175,29321,144711398
0400000US02,02,Alaska,,2015,1020,Financial Administration,1102,6763310,27,41926,1968,1114,1129,6805236
0400000US02,02,Alaska,,2015,1040,Other Government Administration,714,4092382,40,81470,3038,732,754,4173852
0400000US02,02,Alaska,,2015,1060,Judicial and Legal,1467,9458658,49,101938,3324,1487,1516,9560596
0400000US02,02,Alaska,,2015,1100,Police Protection Total,664,4439364,43,30464,1498,673,707,4469828
0400000US02,02,Alaska,,2015,1101,Police Protection - Persons with Power of Arrest       ,309,2673560,0,0,0,309,309,2673560
0400000US02,02,Alaska,,2015,1102,Police Protection - Other ,355,1765804,43,30464,1498,364,398,1796268
0400000US02,02,Alaska,,2015,1120,Fire Protection Total ,0,0,0,0,0,0,0,0
0400000US02,02,Alaska,,2015,1121,Fire Protection - Firefighters,0,0,0,0,0,0,0,0
0400000US02,02,Alaska,,2015,1122,Fire Protection - Other ,0,0,0,0,0,0,0,0
0400000US02,02,Alaska,,2015,1140,Corrections,2222,11815898,53,123288,14406,2309,2275,11939186
0400000US02,02,Alaska,,2015,1160,Highways,3147,18381932,51,91566,4392,3173,3198,18473498
0400000US02,02,Alaska,,2015,1180,Air Transportation,0,0,0,0,0,0,0,0
0400000US02,02,Alaska,,2015,1200,Water Transport and Terminals       ,0,0,0,0,0,0,0,0
0400000US02,02,Alaska,,2015,1220,Public Welfare,1824,9073106,109,193828,16798,1925,1933,9266934
0400000US02,02,Alaska,,2015,1240,Health,720,4254792,16,42112,1142,726,736,4296904
0400000US02,02,Alaska,,2015,1260,Hospitals,234,1385320,37,109578,5662,268,271,1494898
0400000US02,02,Alaska,,2015,1280,Social Insurance Administration,285,1475740,0,0,0,285,285,1475740
0400000US02,02,Alaska,,2015,1300,Solid Waste Management,0,0,0,0,0,0,0,0
0400000US02,02,Alaska,,2015,1320,Sewerage,0,0,0,0,0,0,0,0
0400000US02,02,Alaska,,2015,1340,Parks and Recreation,105,530546,2,4174,198,106,107,534720
0400000US02,02,Alaska,,2015,1360,Housing and Community Development,0,0,0,0,0,0,0,0
0400000US02,02,Alaska,,2015,1380,Natural Resources,2284,13359462,97,193140,6361,2321,2381,13552602
0400000US02,02,Alaska,,2015,1400,Water Supply,0,0,0,0,0,0,0,0
0400000US02,02,Alaska,,2015,1420,Electric Power,0,0,0,0,0,0,0,0
0400000US02,02,Alaska,,2015,1440,Gas Supply,0,0,0,0,0,0,0,0
0400000US02,02,Alaska,,2015,1460,Transit,0,0,0,0,0,0,0,0
0400000US02,02,Alaska,,2015,1480,Education Total ,6739,36587938,4517,5427967,270774,8309,11256,42015905
0400000US02,02,Alaska,,2015,1481,Education - Elementary and Secondary Total ,2622,11182187,1265,1329900,75164,3087,3887,12512087
0400000US02,02,Alaska,,2015,14811,Education - Elementary and Secondary Instructional             ,1912,8772399,601,711606,40197,2159,2513,9484005
0400000US02,02,Alaska,,2015,14812,Education - Elementary and Secondary Other ,710,2409788,664,618294,34967,928,1374,3028082
0400000US02,02,Alaska,,2015,1482,Education - Higher Education Total ,3856,23862595,3225,4076259,194366,4954,7081,27938854
0400000US02,02,Alaska,,2015,14821,Education - Higher Education Instructional,1116,9582288,926,1220457,58043,1444,2042,10802745
0400000US02,02,Alaska,,2015,14822,Education - Higher Education Other ,2740,14280307,2299,2855802,136323,3510,5039,17136109
0400000US02,02,Alaska,,2015,1483,Education - Other,261,1543156,27,21808,1244,268,288,1564964
0400000US02,02,Alaska,,2015,1500,Libraries                          ,0,0,0,0,0,0,0,0
0400000US02,02,Alaska,,2015,1560,State liquor stores,0,0,0,0,0,0,0,0
0400000US02,02,Alaska,,2015,1580,All other and unallocable,2727,16575893,46,75606,3304,2747,2773,16651499
0400000US04,04,Arizona,,2015,1000,Total - All Government Employment Functions,60705,294959159,30916,33882876,2066430,72384,91621,328842035
0400000US04,04,Arizona,,2015,1020,Financial Administration,2433,9718393,34,77067,2802,2450,2467,9795460
0400000US04,04,Arizona,,2015,1040,Other Government Administration,723,3033115,97,205628,8513,770,820,3238743
0400000US04,04,Arizona,,2015,1060,Judicial and Legal,2162,10446377,57,196129,5499,2193,2219,10642506
0400000US04,04,Arizona,,2015,1100,Police Protection Total,1920,9957027,45,76696,2771,1936,1965,10033723
0400000US04,04,Arizona,,2015,1101,Police Protection - Persons with Power of Arrest       ,1164,6569261,1,2447,89,1165,1165,6571708
0400000US04,04,Arizona,,2015,1102,Police Protection - Other ,756,3387766,44,74249,2682,771,800,3462015
0400000US04,04,Arizona,,2015,1120,Fire Protection Total ,0,0,0,0,0,0,0,0
0400000US04,04,Arizona,,2015,1121,Fire Protection - Firefighters,0,0,0,0,0,0,0,0
0400000US04,04,Arizona,,2015,1122,Fire Protection - Other ,0,0,0,0,0,0,0,0
0400000US04,04,Arizona,,2015,1140,Corrections,9637,35013486,14,42443,1159,9644,9651,35055929
0400000US04,04,Arizona,,2015,1160,Highways,2789,12665123,14,38801,1174,2796,2803,12703924
0400000US04,04,Arizona,,2015,1180,Air Transportation,0,0,0,0,0,0,0,0
0400000US04,04,Arizona,,2015,1200,Water Transport and Terminals       ,0,0,0,0,0,0,0,0
0400000US04,04,Arizona,,2015,1220,Public Welfare,6037,20494005,101,250918,10952,6098,6138,20744923
0400000US04,04,Arizona,,2015,1240,Health,2329,9997872,30,80527,2788,2345,2359,10078399
0400000US04,04,Arizona,,2015,1260,Hospitals,641,2645332,9,40043,903,646,650,2685375
0400000US04,04,Arizona,,2015,1280,Social Insurance Administration,1902,5728866,35,50309,3228,1920,1937,5779175
0400000US04,04,Arizona,,2015,1300,Solid Waste Management,0,0,0,0,0,0,0,0
0400000US04,04,Arizona,,2015,1320,Sewerage,0,0,0,0,0,0,0,0
0400000US04,04,Arizona,,2015,1340,Parks and Recreation,367,963874,9,6355,1337,375,376,970229
0400000US04,04,Arizona,,2015,1360,Housing and Community Development,0,0,0,0,0,0,0,0
0400000US04,04,Arizona,,2015,1380,Natural Resources,1477,6356906,226,321843,19356,1587,1703,6678749
0400000US04,04,Arizona,,2015,1400,Water Supply,0,0,0,0,0,0,0,0
0400000US04,04,Arizona,,2015,1420,Electric Power,6,50850,0,0,0,6,6,50850
0400000US04,04,Arizona,,2015,1440,Gas Supply,0,0,0,0,0,0,0,0
0400000US04,04,Arizona,,2015,1460,Transit,0,0,0,0,0,0,0,0
0400000US04,04,Arizona,,2015,1480,Education Total ,25167,154026957,30087,32275769,1996958,36450,55254,186302726
0400000US04,04,Arizona,,2015,1481,Education - Elementary and Secondary Total ,0,0,0,0,0,0,0,0
0400000US04,04,Arizona,,2015,14811,Education - Elementary and Secondary Instructional             ,0,0,0,0,0,0,0,0
0400000US04,04,Arizona,,2015,14812,Education - Elementary and Secondary Other ,0,0,0,0,0,0,0,0
0400000US04,04,Arizona,,2015,1482,Education - Higher Education Total ,22360,143561906,29787,31791345,1966060,33468,52147,175353251
0400000US04,04,Arizona,,2015,14821,Education - Higher Education Instructional,7400,59302966,10628,13993268,707801,11399,18028,73296234
0400000US04,04,Arizona,,2015,14822,Education - Higher Education Other ,14960,84258940,19159,17798077,1258259,22069,34119,102057017
0400000US04,04,Arizona,,2015,1483,Education - Other,2807,10465051,300,484424,30898,2982,3107,10949475
0400000US04,04,Arizona,,2015,1500,Libraries                          ,0,0,0,0,0,0,0,0
0400000US04,04,Arizona,,2015,1560,State liquor stores,0,0,0,0,0,0,0,0
0400000US04,04,Arizona,,2015,1580,All other and unallocable,3115,13860976,158,220348,8990,3168,3273,14081324
0400000US05,05,Arkansas,,2015,1000,Total - All Government Employment Functions,57951,231862897,17340,14977572,945991,63297,75291,246840469
0400000US05,05,Arkansas,,2015,1020,Financial Administration,2459,9514104,15,25338,2364,2472,2474,9539442
0400000US05,05,Arkansas,,2015,1040,Other Government Administration,724,3265470,206,326689,17550,824,930,3592159
0400000US05,05,Arkansas,,2015,1060,Judicial and Legal,1294,4930390,142,436308,12356,1365,1436,5366698
0400000US05,05,Arkansas,,2015,1100,Police Protection Total,1221,4640642,15,21189,1355,1229,1236,4661831
0400000US05,05,Arkansas,,2015,1101,Police Protection - Persons with Power of Arrest       ,547,2458315,0,0,0,547,547,2458315
0400000US05,05,Arkansas,,2015,1102,Police Protection - Other ,674,2182327,15,21189,1355,682,689,2203516
0400000US05,05,Arkansas,,2015,1120,Fire Protection Total ,0,0,0,0,0,0,0,0
0400000US05,05,Arkansas,,2015,1121,Fire Protection - Firefighters,0,0,0,0,0,0,0,0
0400000US05,05,Arkansas,,2015,1122,Fire Protection - Other ,0,0,0,0,0,0,0,0
0400000US05,05,Arkansas,,2015,1140,Corrections,5495,17482669,7,13733,688,5499,5502,17496402
0400000US05,05,Arkansas,,2015,1160,Highways,3480,13717830,29,58247,3792,3501,3509,13776077
0400000US05,05,Arkansas,,2015,1180,Air Transportation,3,17424,0,0,0,3,3,17424
0400000US05,05,Arkansas,,2015,1200,Water Transport and Terminals       ,0,0,0,0,0,0,0,0
0400000US05,05,Arkansas,,2015,1220,Public Welfare,4167,12989398,54,52471,3915,4189,4221,13041869
0400000US05,05,Arkansas,,2015,1240,Health,3656,13917044,131,269527,11807,3723,3787,14186571
0400000US05,05,Arkansas,,2015,1260,Hospitals,6401,23906142,491,901770,54387,6708,6892,24807912
0400000US05,05,Arkansas,,2015,1280,Social Insurance Administration,1314,4360546,8,51894,1267,1321,1322,4412440
0400000US05,05,Arkansas,,2015,1300,Solid Waste Management,0,0,0,0,0,0,0,0
0400000US05,05,Arkansas,,2015,1320,Sewerage,0,0,0,0,0,0,0,0
0400000US05,05,Arkansas,,2015,1340,Parks and Recreation,1029,2327099,8,3401,567,1032,1037,2330500
0400000US05,05,Arkansas,,2015,1360,Housing and Community Development,0,0,0,0,0,0,0,0
0400000US05,05,Arkansas,,2015,1380,Natural Resources,1824,6488434,385,237789,19142,1932,2209,6726223
0400000US05,05,Arkansas,,2015,1400,Water Supply,0,0,0,0,0,0,0,0
0400000US05,05,Arkansas,,2015,1420,Electric Power,0,0,0,0,0,0,0,0
0400000US05,05,Arkansas,,2015,1440,Gas Supply,0,0,0,0,0,0,0,0
0400000US05,05,Arkansas,,2015,1460,Transit,0,0,0,0,0,0,0,0
0400000US05,05,Arkansas,,2015,1480,Education Total ,22821,106677162,15754,12480861,810893,27402,38575,119158023
0400000US05,05,Arkansas,,2015,1481,Education - Elementary and Secondary Total ,0,0,0,0,0,0,0,0
0400000US05,05,Arkansas,,2015,14811,Education - Elementary and Secondary Instructional             ,0,0,0,0,0,0,0,0
0400000US05,05,Arkansas,,2015,14812,Education - Elementary and Secondary Other ,0,0,0,0,0,0,0,0
0400000US05,05,Arkansas,,2015,1482,Education - Higher Education Total ,21438,101408821,15734,12446008,808962,26008,37172,113854829
0400000US05,05,Arkansas,,2015,14821,Education - Higher Education Instructional,6648,48558570,5667,7057368,369774,8736,12315,55615938
0400000US05,05,Arkansas,,2015,14822,Education - Higher Education Other ,14790,52850251,10067,5388640,439188,17272,24857,58238891
0400000US05,05,Arkansas,,2015,1483,Education - Other,1383,5268341,20,34853,1931,1394,1403,5303194
0400000US05,05,Arkansas,,2015,1500,Libraries                          ,47,154444,3,1798,179,48,50,156242
0400000US05,05,Arkansas,,2015,1560,State liquor stores,0,0,0,0,0,0,0,0
0400000US05,05,Arkansas,,2015,1580,All other and unallocable,2016,7474099,92,96557,5729,2049,2108,7570656
0400000US06,06,California,,2015,1000,Total - All Government Employment Functions,337637,2323373484,170871,356469078,11901054,404882,508508,2679842562
0400000US06,06,California,,2015,1020,Financial Administration,25508,130577030,3224,6733348,377818,27643,28732,137310378
0400000US06,06,California,,2015,1040,Other Government Administration,3718,21477262,293,813239,28237,3885,4011,22290501
0400000US06,06,California,,2015,1060,Judicial and Legal,6020,41370012,466,1305622,40478,6248,6486,42675634
0400000US06,06,California,,2015,1100,Police Protection Total,11221,92720815,249,187935,6469,11257,11470,92908750
0400000US06,06,California,,2015,1101,Police Protection - Persons with Power of Arrest       ,7702,77976239,201,90669,2030,7713,7903,78066908
0400000US06,06,California,,2015,1102,Police Protection - Other ,3519,14744576,48,97266,4439,3544,3567,14841842
0400000US06,06,California,,2015,1120,Fire Protection Total ,0,0,0,0,0,0,0,0
0400000US06,06,California,,2015,1121,Fire Protection - Firefighters,0,0,0,0,0,0,0,0
0400000US06,06,California,,2015,1122,Fire Protection - Other ,0,0,0,0,0,0,0,0
0400000US06,06,California,,2015,1140,Corrections,53858,404160576,1824,6741772,230371,55160,55682,410902348
0400000US06,06,California,,2015,1160,Highways,18215,140383381,935,3518111,136319,18986,19150,143901492
0400000US06,06,California,,2015,1180,Air Transportation,0,0,0,0,0,0,0,0
0400000US06,06,California,,2015,1200,Water Transport and Terminals       ,0,0,0,0,0,0,0,0
0400000US06,06,California,,2015,1220,Public Welfare,3677,18876793,318,456050,19898,3789,3995,19332843
0400000US06,06,California,,2015,1240,Health,14127,89160341,1951,5760744,209877,15312,16078,94921085
0400000US06,06,California,,2015,1260,Hospitals,30752,248955259,18384,122010530,2335226,43945,49136,370965789
0400000US06,06,California,,2015,1280,Social Insurance Administration,12745,64980714,1416,4042792,187697,13805,14161,69023506
0400000US06,06,California,,2015,1300,Solid Waste Management,651,3976428,81,192153,9134,703,732,4168581
0400000US06,06,California,,2015,1320,Sewerage,0,0,0,0,0,0,0,0
0400000US06,06,California,,2015,1340,Parks and Recreation,2067,11052137,2114,3397117,231232,3373,4181,14449254
0400000US06,06,California,,2015,1360,Housing and Community Development,0,0,0,0,0,0,0,0
0400000US06,06,California,,2015,1380,Natural Resources,13842,90179533,3004,5808613,388117,16033,16846,95988146
0400000US06,06,California,,2015,1400,Water Supply,0,0,0,0,0,0,0,0
0400000US06,06,California,,2015,1420,Electric Power,0,0,0,0,0,0,0,0
0400000US06,06,California,,2015,1440,Gas Supply,0,0,0,0,0,0,0,0
0400000US06,06,California,,2015,1460,Transit,0,0,0,0,0,0,0,0
0400000US06,06,California,,2015,1480,Education Total ,121911,846361045,134829,190861193,7565331,164654,256740,1037222238
0400000US06,06,California,,2015,1481,Education - Elementary and Secondary Total ,0,0,0,0,0,0,0,0
0400000US06,06,California,,2015,14811,Education - Elementary and Secondary Instructional             ,0,0,0,0,0,0,0,0
0400000US06,06,California,,2015,14812,Education - Elementary and Secondary Other ,0,0,0,0,0,0,0,0
0400000US06,06,California,,2015,1482,Education - Higher Education Total ,117834,825062567,134409,190033895,7526608,160357,252243,1015096462
0400000US06,06,California,,2015,14821,Education - Higher Education Instructional,25897,238805506,33712,66062650,2169402,38154,59609,304868156
0400000US06,06,California,,2015,14822,Education - Higher Education Other ,91937,586257061,100697,123971245,5357206,122203,192634,710228306
0400000US06,06,California,,2015,1483,Education - Other,4077,21298478,420,827298,38723,4297,4497,22125776
0400000US06,06,California,,2015,1500,Libraries                          ,0,0,0,0,0,0,0,0
0400000US06,06,California,,2015,1560,State liquor stores,0,0,0,0,0,0,0,0
0400000US06,06,California,,2015,1580,All other and unallocable,19325,119142158,1783,4639859,134850,20089,21108,123782017
0400000US08,08,Colorado,,2015,1000,Total - All Government Employment Functions,59036,329191916,47564,87328198,4422321,84828,106600,416520114
0400000US08,08,Colorado,,2015,1020,Financial Administration,1866,9799944,68,133935,7210,1907,1934,9933879
0400000US08,08,Colorado,,2015,1040,Other Government Administration,446,2148533,171,347648,19890,558,617,2496181
0400000US08,08,Colorado,,2015,1060,Judicial and Legal,4605,25660905,508,1187716,65342,4974,5113,26848621
0400000US08,08,Colorado,,2015,1100,Police Protection Total,1255,6926187,17,39399,1390,1263,1272,6965586
0400000US08,08,Colorado,,2015,1101,Police Protection - Persons with Power of Arrest       ,754,4576054,0,0,0,754,754,4576054
0400000US08,08,Colorado,,2015,1102,Police Protection - Other ,501,2350133,17,39399,1390,509,518,2389532
0400000US08,08,Colorado,,2015,1120,Fire Protection Total ,0,0,0,0,0,0,0,0
0400000US08,08,Colorado,,2015,1121,Fire Protection - Firefighters,0,0,0,0,0,0,0,0
0400000US08,08,Colorado,,2015,1122,Fire Protection - Other ,0,0,0,0,0,0,0,0
0400000US08,08,Colorado,,2015,1140,Corrections,7196,30966376,53,186485,7809,7241,7249,31152861
0400000US08,08,Colorado,,2015,1160,Highways,2963,14385396,181,360093,20598,3079,3144,14745489
0400000US08,08,Colorado,,2015,1180,Air Transportation,0,0,0,0,0,0,0,0
0400000US08,08,Colorado,,2015,1200,Water Transport and Terminals       ,0,0,0,0,0,0,0,0
0400000US08,08,Colorado,,2015,1220,Public Welfare,2169,9832679,288,567371,32454,2353,2457,10400050
0400000US08,08,Colorado,,2015,1240,Health,1230,7189613,137,350601,20055,1343,1367,7540214
0400000US08,08,Colorado,,2015,1260,Hospitals,4992,21781178,1047,5777600,226507,6325,6039,27558778
0400000US08,08,Colorado,,2015,1280,Social Insurance Administration,934,4573695,188,373905,21387,1055,1122,4947600
0400000US08,08,Colorado,,2015,1300,Solid Waste Management,0,0,0,0,0,0,0,0
0400000US08,08,Colorado,,2015,1320,Sewerage,0,0,0,0,0,0,0,0
0400000US08,08,Colorado,,2015,1340,Parks and Recreation,886,4536627,235,239783,13715,963,1121,4776410
0400000US08,08,Colorado,,2015,1360,Housing and Community Development,0,0,0,0,0,0,0,0
0400000US08,08,Colorado,,2015,1380,Natural Resources,995,5476383,214,397880,22266,1121,1209,5874263
0400000US08,08,Colorado,,2015,1400,Water Supply,0,0,0,0,0,0,0,0
0400000US08,08,Colorado,,2015,1420,Electric Power,0,0,0,0,0,0,0,0
0400000US08,08,Colorado,,2015,1440,Gas Supply,0,0,0,0,0,0,0,0
0400000US08,08,Colorado,,2015,1460,Transit,0,0,0,0,0,0,0,0
0400000US08,08,Colorado,,2015,1480,Education Total ,27143,172736498,44387,77144629,3951141,50219,71530,249881127
0400000US08,08,Colorado,,2015,1481,Education - Elementary and Secondary Total ,0,0,0,0,0,0,0,0
0400000US08,08,Colorado,,2015,14811,Education - Elementary and Secondary Instructional             ,0,0,0,0,0,0,0,0
0400000US08,08,Colorado,,2015,14812,Education - Elementary and Secondary Other ,0,0,0,0,0,0,0,0
0400000US08,08,Colorado,,2015,1482,Education - Higher Education Total ,25975,166648417,43240,75881062,3871620,48601,69215,242529479
0400000US08,08,Colorado,,2015,14821,Education - Higher Education Instructional,9668,84926116,15961,42736867,1750445,19950,25629,127662983
0400000US08,08,Colorado,,2015,14822,Education - Higher Education Other ,16307,81722301,27279,33144195,2121175,28651,43586,114866496
0400000US08,08,Colorado,,2015,1483,Education - Other,1168,6088081,1147,1263567,79521,1618,2315,7351648
0400000US08,08,Colorado,,2015,1500,Libraries                          ,0,0,0,0,0,0,0,0
0400000US08,08,Colorado,,2015,1560,State liquor stores,0,0,0,0,0,0,0,0
0400000US08,08,Colorado,,2015,1580,All other and unallocable,2356,13177902,70,221153,12557,2427,2426,13399055
0400000US09,09,Connecticut,,2015,1000,Total - All Government Employment Functions,53248,335631361,24322,42936055,1612068,62848,77570,378567416
0400000US09,09,Connecticut,,2015,1020,Financial Administration,1730,10817974,65,190893,6304,1767,1795,11008867
0400000US09,09,Connecticut,,2015,1040,Other Government Administration,1482,9406884,242,856444,27950,1639,1724,10263328
0400000US09,09,Connecticut,,2015,1060,Judicial and Legal,6043,31786135,342,836431,14485,6125,6385,32622566
0400000US09,09,Connecticut,,2015,1100,Police Protection Total,1887,13594013,239,169454,6198,1921,2126,13763467
0400000US09,09,Connecticut,,2015,1101,Police Protection - Persons with Power of Arrest       ,1222,9782314,3,4723,235,1223,1225,9787037
0400000US09,09,Connecticut,,2015,1102,Police Protection - Other ,665,3811699,236,164731,5963,698,901,3976430
0400000US09,09,Connecticut,,2015,1120,Fire Protection Total ,0,0,0,0,0,0,0,0
0400000US09,09,Connecticut,,2015,1121,Fire Protection - Firefighters,0,0,0,0,0,0,0,0
0400000US09,09,Connecticut,,2015,1122,Fire Protection - Other ,0,0,0,0,0,0,0,0
0400000US09,09,Connecticut,,2015,1140,Corrections,5742,35109474,62,226686,5583,5773,5804,35336160
0400000US09,09,Connecticut,,2015,1160,Highways,3277,18497543,2,11435,361,3279,3279,18508978
0400000US09,09,Connecticut,,2015,1180,Air Transportation,147,973413,0,0,0,147,147,973413
0400000US09,09,Connecticut,,2015,1200,Water Transport and Terminals       ,0,0,0,0,0,0,0,0
0400000US09,09,Connecticut,,2015,1220,Public Welfare,5357,33338000,419,1874216,62323,5710,5776,35212216
0400000US09,09,Connecticut,,2015,1240,Health,3622,21693620,472,1816133,42753,3864,4094,23509753
0400000US09,09,Connecticut,,2015,1260,Hospitals,4922,32916591,1761,7589449,274013,6470,6683,40506040
0400000US09,09,Connecticut,,2015,1280,Social Insurance Administration,636,4229434,1,2345,91,637,637,4231779
0400000US09,09,Connecticut,,2015,1300,Solid Waste Management,43,282175,3,8319,359,45,46,290494
0400000US09,09,Connecticut,,2015,1320,Sewerage,0,0,0,0,0,0,0,0
0400000US09,09,Connecticut,,2015,1340,Parks and Recreation,160,868963,11,18091,793,164,171,887054
0400000US09,09,Connecticut,,2015,1360,Housing and Community Development,49,304878,0,0,0,49,49,304878
0400000US09,09,Connecticut,,2015,1380,Natural Resources,668,3882765,76,177909,6500,703,744,4060674
0400000US09,09,Connecticut,,2015,1400,Water Supply,0,0,0,0,0,0,0,0
0400000US09,09,Connecticut,,2015,1420,Electric Power,0,0,0,0,0,0,0,0
0400000US09,09,Connecticut,,2015,1440,Gas Supply,0,0,0,0,0,0,0,0
0400000US09,09,Connecticut,,2015,1460,Transit,0,0,0,0,0,0,0,0
0400000US09,09,Connecticut,,2015,1480,Education Total ,15094,102778052,20260,28570091,1138723,22022,35354,131348143
0400000US09,09,Connecticut,,2015,1481,Education - Elementary and Secondary Total ,0,0,0,0,0,0,0,0
0400000US09,09,Connecticut,,2015,14811,Education - Elementary and Secondary Instructional             ,0,0,0,0,0,0,0,0
0400000US09,09,Connecticut,,2015,14812,Education - Elementary and Secondary Other ,0,0,0,0,0,0,0,0
0400000US09,09,Connecticut,,2015,1482,Education - Higher Education Total ,12550,87725148,19234,25805549,1041702,18929,31784,113530697
0400000US09,09,Connecticut,,2015,14821,Education - Higher Education Instructional,4602,39129782,7528,15134812,432397,7268,12130,54264594
0400000US09,09,Connecticut,,2015,14822,Education - Higher Education Other ,7948,48595366,11706,10670737,609305,11661,19654,59266103
0400000US09,09,Connecticut,,2015,1483,Education - Other,2544,15052904,1026,2764542,97021,3093,3570,17817446
0400000US09,09,Connecticut,,2015,1500,Libraries                          ,0,0,0,0,0,0,0,0
0400000US09,09,Connecticut,,2015,1560,State liquor stores,0,0,0,0,0,0,0,0
0400000US09,09,Connecticut,,2015,1580,All other and unallocable,2389,15151447,367,588159,25632,2533,2756,15739606
0400000US10,10,Delaware,,2015,1000,Total - All Government Employment Functions,22933,105349550,8422,11927831,517366,26052,31355,117277381
0400000US10,10,Delaware,,2015,1020,Financial Administration,804,2609395,22,25475,1497,814,826,2634870
0400000US10,10,Delaware,,2015,1040,Other Government Administration,397,1717888,157,171853,3000,416,554,1889741
0400000US10,10,Delaware,,2015,1060,Judicial and Legal,1775,8379581,49,107198,5403,1807,1824,8486779
0400000US10,10,Delaware,,2015,1100,Police Protection Total,1091,7311342,15,29579,1411,1100,1106,7340921
0400000US10,10,Delaware,,2015,1101,Police Protection - Persons with Power of Arrest       ,866,6226997,6,9606,609,870,872,6236603
0400000US10,10,Delaware,,2015,1102,Police Protection - Other ,225,1084345,9,19973,802,230,234,1104318
0400000US10,10,Delaware,,2015,1120,Fire Protection Total ,0,0,0,0,0,0,0,0
0400000US10,10,Delaware,,2015,1121,Fire Protection - Firefighters,0,0,0,0,0,0,0,0
0400000US10,10,Delaware,,2015,1122,Fire Protection - Other ,0,0,0,0,0,0,0,0
0400000US10,10,Delaware,,2015,1140,Corrections,2886,11950778,46,70171,5135,2917,2932,12020949
0400000US10,10,Delaware,,2015,1160,Highways,1480,4957697,1,1504,131,1481,1481,4959201
0400000US10,10,Delaware,,2015,1180,Air Transportation,0,0,0,0,0,0,0,0
0400000US10,10,Delaware,,2015,1200,Water Transport and Terminals       ,280,1154895,0,0,0,280,280,1154895
0400000US10,10,Delaware,,2015,1220,Public Welfare,1470,5224868,131,268549,14842,1560,1601,5493417
0400000US10,10,Delaware,,2015,1240,Health,2009,7790734,187,369762,19575,2127,2196,8160496
0400000US10,10,Delaware,,2015,1260,Hospitals,1259,4495253,121,186989,10356,1321,1380,4682242
0400000US10,10,Delaware,,2015,1280,Social Insurance Administration,312,1015890,23,39596,1636,322,335,1055486
0400000US10,10,Delaware,,2015,1300,Solid Waste Management,118,481069,20,32530,2502,133,138,513599
0400000US10,10,Delaware,,2015,1320,Sewerage,0,0,0,0,0,0,0,0
0400000US10,10,Delaware,,2015,1340,Parks and Recreation,303,788461,27,20422,1473,312,330,808883
0400000US10,10,Delaware,,2015,1360,Housing and Community Development,0,0,0,0,0,0,0,0
0400000US10,10,Delaware,,2015,1380,Natural Resources,434,1781985,53,79920,4276,460,487,1861905
0400000US10,10,Delaware,,2015,1400,Water Supply,0,0,0,0,0,0,0,0
0400000US10,10,Delaware,,2015,1420,Electric Power,0,0,0,0,0,0,0,0
0400000US10,10,Delaware,,2015,1440,Gas Supply,0,0,0,0,0,0,0,0
0400000US10,10,Delaware,,2015,1460,Transit,928,4154886,28,48099,2442,942,956,4202985
0400000US10,10,Delaware,,2015,1480,Education Total ,5707,34393300,7191,10197364,428856,8290,12898,44590664
0400000US10,10,Delaware,,2015,1481,Education - Elementary and Secondary Total ,0,0,0,0,0,0,0,0
0400000US10,10,Delaware,,2015,14811,Education - Elementary and Secondary Instructional             ,0,0,0,0,0,0,0,0
0400000US10,10,Delaware,,2015,14812,Education - Elementary and Secondary Other ,0,0,0,0,0,0,0,0
0400000US10,10,Delaware,,2015,1482,Education - Higher Education Total ,5374,32384159,7168,10165201,427249,7947,12542,42549360
0400000US10,10,Delaware,,2015,14821,Education - Higher Education Instructional,1518,12551639,3019,5576105,163403,2502,4537,18127744
0400000US10,10,Delaware,,2015,14822,Education - Higher Education Other ,3856,19832520,4149,4589096,263846,5445,8005,24421616
0400000US10,10,Delaware,,2015,1483,Education - Other,333,2009141,23,32163,1607,343,356,2041304
0400000US10,10,Delaware,,2015,1500,Libraries                          ,0,0,0,0,0,0,0,0
0400000US10,10,Delaware,,2015,1560,State liquor stores,0,0,0,0,0,0,0,0
0400000US10,10,Delaware,,2015,1580,All other and unallocable,1680,7141528,351,278820,14831,1770,2031,7420348
0400000US12,12,Florida,,2015,1000,Total - All Government Employment Functions,159895,693483277,47208,57877541,3172857,177827,207103,751360818
0400000US12,12,Florida,,2015,1020,Financial Administration,6315,22596883,130,169209,10199,6373,6445,22766092
0400000US12,12,Florida,,2015,1040,Other Government Administration,1970,8853093,229,223013,18458,2074,2199,9076106
0400000US12,12,Florida,,2015,1060,Judicial and Legal,19218,80226387,755,1270506,66103,19594,19973,81496893
0400000US12,12,Florida,,2015,1100,Police Protection Total,4020,16378080,360,520626,20723,4137,4380,16898706
0400000US12,12,Florida,,2015,1101,Police Protection - Persons with Power of Arrest       ,2237,10016589,181,252455,6151,2272,2418,10269044
0400000US12,12,Florida,,2015,1102,Police Protection - Other ,1783,6361491,179,268171,14572,1865,1962,6629662
0400000US12,12,Florida,,2015,1120,Fire Protection Total ,0,0,0,0,0,0,0,0
0400000US12,12,Florida,,2015,1121,Fire Protection - Firefighters,0,0,0,0,0,0,0,0
0400000US12,12,Florida,,2015,1122,Fire Protection - Other ,0,0,0,0,0,0,0,0
0400000US12,12,Florida,,2015,1140,Corrections,23379,77091371,258,206850,14385,23460,23637,77298221
0400000US12,12,Florida,,2015,1160,Highways,6384,28770270,54,42476,2881,6401,6438,28812746
0400000US12,12,Florida,,2015,1180,Air Transportation,0,0,0,0,0,0,0,0
0400000US12,12,Florida,,2015,1200,Water Transport and Terminals       ,0,0,0,0,0,0,0,0
0400000US12,12,Florida,,2015,1220,Public Welfare,9044,28781842,259,276862,19858,9157,9303,29058704
0400000US12,12,Florida,,2015,1240,Health,16176,54539759,932,1907112,95766,16716,17108,56446871
0400000US12,12,Florida,,2015,1260,Hospitals,3933,13456779,57,118024,4889,3961,3990,13574803
0400000US12,12,Florida,,2015,1280,Social Insurance Administration,2798,9307142,59,94563,4820,2825,2857,9401705
0400000US12,12,Florida,,2015,1300,Solid Waste Management,0,0,0,0,0,0,0,0
0400000US12,12,Florida,,2015,1320,Sewerage,0,0,0,0,0,0,0,0
0400000US12,12,Florida,,2015,1340,Parks and Recreation,1120,2803686,300,275500,23304,1252,1420,3079186
0400000US12,12,Florida,,2015,1360,Housing and Community Development,0,0,0,0,0,0,0,0
0400000US12,12,Florida,,2015,1380,Natural Resources,7595,26756277,662,786350,54939,7905,8257,27542627
0400000US12,12,Florida,,2015,1400,Water Supply,0,0,0,0,0,0,0,0
0400000US12,12,Florida,,2015,1420,Electric Power,0,0,0,0,0,0,0,0
0400000US12,12,Florida,,2015,1440,Gas Supply,0,0,0,0,0,0,0,0
0400000US12,12,Florida,,2015,1460,Transit,682,3124996,71,119878,8791,732,753,3244874
0400000US12,12,Florida,,2015,1480,Education Total ,51274,299432078,42726,51480268,2803851,67118,94000,350912346
0400000US12,12,Florida,,2015,1481,Education - Elementary and Secondary Total ,0,0,0,0,0,0,0,0
0400000US12,12,Florida,,2015,14811,Education - Elementary and Secondary Instructional             ,0,0,0,0,0,0,0,0
0400000US12,12,Florida,,2015,14812,Education - Elementary and Secondary Other ,0,0,0,0,0,0,0,0
0400000US12,12,Florida,,2015,1482,Education - Higher Education Total ,48366,289008094,42406,51204737,2788538,64123,90772,340212831
0400000US12,12,Florida,,2015,14821,Education - Higher Education Instructional,13761,140003378,15839,30275377,1242278,20781,29600,170278755
0400000US12,12,Florida,,2015,14822,Education - Higher Education Other ,34605,149004716,26567,20929360,1546260,43342,61172,169934076
0400000US12,12,Florida,,2015,1483,Education - Other,2908,10423984,320,275531,15313,2995,3228,10699515
0400000US12,12,Florida,,2015,1500,Libraries                          ,0,0,0,0,0,0,0,0
0400000US12,12,Florida,,2015,1560,State liquor stores,0,0,0,0,0,0,0,0
0400000US12,12,Florida,,2015,1580,All other and unallocable,5987,21364634,356,386304,23890,6122,6343,21750938
0400000US13,13,Georgia,,2015,1000,Total - All Government Employment Functions,111718,466574765,49087,47111422,2489727,125791,160805,513686187
0400000US13,13,Georgia,,2015,1020,Financial Administration,3032,11389702,289,338600,26822,3183,3321,11728302
0400000US13,13,Georgia,,2015,1040,Other Government Administration,1163,3880158,48,88852,3812,1185,1211,3969010
0400000US13,13,Georgia,,2015,1060,Judicial and Legal,3642,16208042,85,105888,5291,3672,3727,16313930
0400000US13,13,Georgia,,2015,1100,Police Protection Total,2811,10175740,59,81438,6112,2846,2870,10257178
0400000US13,13,Georgia,,2015,1101,Police Protection - Persons with Power of Arrest       ,1658,5683418,11,16612,982,1664,1669,5700030
0400000US13,13,Georgia,,2015,1102,Police Protection - Other ,1153,4492322,48,64826,5130,1182,1201,4557148
0400000US13,13,Georgia,,2015,1120,Fire Protection Total ,0,0,0,0,0,0,0,0
0400000US13,13,Georgia,,2015,1121,Fire Protection - Firefighters,0,0,0,0,0,0,0,0
0400000US13,13,Georgia,,2015,1122,Fire Protection - Other ,0,0,0,0,0,0,0,0
0400000US13,13,Georgia,,2015,1140,Corrections,16188,42597558,725,1065868,46418,16450,16913,43663426
0400000US13,13,Georgia,,2015,1160,Highways,4334,14237752,206,211076,22492,4461,4540,14448828
0400000US13,13,Georgia,,2015,1180,Air Transportation,2,8510,0,0,0,2,2,8510
0400000US13,13,Georgia,,2015,1200,Water Transport and Terminals       ,983,7561221,0,0,0,983,983,7561221
0400000US13,13,Georgia,,2015,1220,Public Welfare,6638,22266258,41,27426,1076,6645,6679,22293684
0400000US13,13,Georgia,,2015,1240,Health,3654,15315095,80,136159,5231,3683,3734,15451254
0400000US13,13,Georgia,,2015,1260,Hospitals,7564,29648845,298,454539,20117,7678,7862,30103384
0400000US13,13,Georgia,,2015,1280,Social Insurance Administration,1614,4151254,87,134652,8606,1663,1701,4285906
0400000US13,13,Georgia,,2015,1300,Solid Waste Management,0,0,0,0,0,0,0,0
0400000US13,13,Georgia,,2015,1320,Sewerage,0,0,0,0,0,0,0,0
0400000US13,13,Georgia,,2015,1340,Parks and Recreation,2788,7128392,1006,1104671,119651,3464,3794,8233063
0400000US13,13,Georgia,,2015,1360,Housing and Community Development,0,0,0,0,0,0,0,0
0400000US13,13,Georgia,,2015,1380,Natural Resources,4231,15161313,1112,1191960,76137,4661,5343,16353273
0400000US13,13,Georgia,,2015,1400,Water Supply,0,0,0,0,0,0,0,0
0400000US13,13,Georgia,,2015,1420,Electric Power,0,0,0,0,0,0,0,0
0400000US13,13,Georgia,,2015,1440,Gas Supply,0,0,0,0,0,0,0,0
0400000US13,13,Georgia,,2015,1460,Transit,0,0,0,0,0,0,0,0
0400000US13,13,Georgia,,2015,1480,Education Total ,50958,258652064,44940,42036125,2138827,63048,95898,300688189
0400000US13,13,Georgia,,2015,1481,Education - Elementary and Secondary Total ,0,0,0,0,0,0,0,0
0400000US13,13,Georgia,,2015,14811,Education - Elementary and Secondary Instructional             ,0,0,0,0,0,0,0,0
0400000US13,13,Georgia,,2015,14812,Education - Elementary and Secondary Other ,0,0,0,0,0,0,0,0
0400000US13,13,Georgia,,2015,1482,Education - Higher Education Total ,48610,247145024,44802,41821910,2129480,60647,93412,288966934
0400000US13,13,Georgia,,2015,14821,Education - Higher Education Instructional,15073,99412269,18267,26388148,1005281,20755,33340,125800417
0400000US13,13,Georgia,,2015,14822,Education - Higher Education Other ,33537,147732755,26535,15433762,1124199,39892,60072,163166517
0400000US13,13,Georgia,,2015,1483,Education - Other,2348,11507040,138,214215,9347,2401,2486,11721255
0400000US13,13,Georgia,,2015,1500,Libraries                          ,0,0,0,0,0,0,0,0
0400000US13,13,Georgia,,2015,1560,State liquor stores,0,0,0,0,0,0,0,0
0400000US13,13,Georgia,,2015,1580,All other and unallocable,2116,8192861,111,134168,9135,2167,2227,8327029
0400000US15,15,Hawaii,,2015,1000,Total - All Government Employment Functions,52499,243113508,19544,20231456,1004129,58415,72043,263344964
0400000US15,15,Hawaii,,2015,1020,Financial Administration,694,3055538,0,0,0,694,694,3055538
0400000US15,15,Hawaii,,2015,1040,Other Government Administration,700,3292257,144,361297,14890,784,844,3653554
0400000US15,15,Hawaii,,2015,1060,Judicial and Legal,2506,12292830,59,180250,3926,2527,2565,12473080
0400000US15,15,Hawaii,,2015,1100,Police Protection Total,0,0,0,0,0,0,0,0
0400000US15,15,Hawaii,,2015,1101,Police Protection - Persons with Power of Arrest       ,0,0,0,0,0,0,0,0
0400000US15,15,Hawaii,,2015,1102,Police Protection - Other ,0,0,0,0,0,0,0,0
0400000US15,15,Hawaii,,2015,1120,Fire Protection Total ,0,0,0,0,0,0,0,0
0400000US15,15,Hawaii,,2015,1121,Fire Protection - Firefighters,0,0,0,0,0,0,0,0
0400000US15,15,Hawaii,,2015,1122,Fire Protection - Other ,0,0,0,0,0,0,0,0
0400000US15,15,Hawaii,,2015,1140,Corrections,2545,12313352,9,35262,625,2548,2554,12348614
0400000US15,15,Hawaii,,2015,1160,Highways,870,4229126,9,14757,1482,878,879,4243883
0400000US15,15,Hawaii,,2015,1180,Air Transportation,1013,4559306,9,14940,684,1017,1022,4574246
0400000US15,15,Hawaii,,2015,1200,Water Transport and Terminals       ,228,1006754,2,2288,460,231,230,1009042
0400000US15,15,Hawaii,,2015,1220,Public Welfare,417,1882744,21,12602,1596,426,438,1895346
0400000US15,15,Hawaii,,2015,1240,Health,1930,9767276,34,100692,3068,1947,1964,9867968
0400000US15,15,Hawaii,,2015,1260,Hospitals,4254,22584235,839,2253665,64996,4622,5093,24837900
0400000US15,15,Hawaii,,2015,1280,Social Insurance Administration,215,964872,14,36928,1378,223,229,1001800
0400000US15,15,Hawaii,,2015,1300,Solid Waste Management,0,0,0,0,0,0,0,0
0400000US15,15,Hawaii,,2015,1320,Sewerage,0,0,0,0,0,0,0,0
0400000US15,15,Hawaii,,2015,1340,Parks and Recreation,144,580884,551,114584,6746,182,695,695468
0400000US15,15,Hawaii,,2015,1360,Housing and Community Development,0,0,0,0,0,0,0,0
0400000US15,15,Hawaii,,2015,1380,Natural Resources,812,3752434,21,67664,2976,829,833,3820098
0400000US15,15,Hawaii,,2015,1400,Water Supply,0,0,0,0,0,0,0,0
0400000US15,15,Hawaii,,2015,1420,Electric Power,0,0,0,0,0,0,0,0
0400000US15,15,Hawaii,,2015,1440,Gas Supply,0,0,0,0,0,0,0,0
0400000US15,15,Hawaii,,2015,1460,Transit,0,0,0,0,0,0,0,0
0400000US15,15,Hawaii,,2015,1480,Education Total ,31974,144217676,17539,16749608,879454,37187,49513,160967284
0400000US15,15,Hawaii,,2015,1481,Education - Elementary and Secondary Total ,22217,95422722,12157,12294820,652718,26149,34374,107717542
0400000US15,15,Hawaii,,2015,14811,Education - Elementary and Secondary Instructional             ,17044,78732562,10590,10960464,586430,20577,27634,89693026
0400000US15,15,Hawaii,,2015,14812,Education - Elementary and Secondary Other ,5173,16690160,1567,1334356,66288,5572,6740,18024516
0400000US15,15,Hawaii,,2015,1482,Education - Higher Education Total ,9622,48240104,5381,4452082,226464,10901,15003,52692186
0400000US15,15,Hawaii,,2015,14821,Education - Higher Education Instructional,3748,25299738,887,1116946,36668,3955,4635,26416684
0400000US15,15,Hawaii,,2015,14822,Education - Higher Education Other ,5874,22940366,4494,3335136,189796,6946,10368,26275502
0400000US15,15,Hawaii,,2015,1483,Education - Other,135,554850,1,2706,272,137,136,557556
0400000US15,15,Hawaii,,2015,1500,Libraries                          ,448,1673066,245,212164,17904,549,693,1885230
0400000US15,15,Hawaii,,2015,1560,State liquor stores,0,0,0,0,0,0,0,0
0400000US15,15,Hawaii,,2015,1580,All other and unallocable,3749,16941158,48,74755,3944,3771,3797,17015913
0400000US16,16,Idaho,,2015,1000,Total - All Government Employment Functions,20303,99020548,10359,11173026,580384,23583,30662,110193574
0400000US16,16,Idaho,,2015,1020,Financial Administration,1209,6471884,117,220717,15311,1294,1326,6692601
0400000US16,16,Idaho,,2015,1040,Other Government Administration,226,1193656,93,252871,15778,316,319,1446527
0400000US16,16,Idaho,,2015,1060,Judicial and Legal,516,4776282,51,150853,3296,534,567,4927135
0400000US16,16,Idaho,,2015,1100,Police Protection Total,483,2272860,20,29222,1515,492,503,2302082
0400000US16,16,Idaho,,2015,1101,Police Protection - Persons with Power of Arrest       ,271,1443524,0,0,0,271,271,1443524
0400000US16,16,Idaho,,2015,1102,Police Protection - Other ,212,829336,20,29222,1515,221,232,858558
0400000US16,16,Idaho,,2015,1120,Fire Protection Total ,0,0,0,0,0,0,0,0
0400000US16,16,Idaho,,2015,1121,Fire Protection - Firefighters,0,0,0,0,0,0,0,0
0400000US16,16,Idaho,,2015,1122,Fire Protection - Other ,0,0,0,0,0,0,0,0
0400000US16,16,Idaho,,2015,1140,Corrections,2371,11625217,29,67421,3271,2390,2400,11692638
0400000US16,16,Idaho,,2015,1160,Highways,1342,5363959,56,101890,9121,1394,1398,5465849
0400000US16,16,Idaho,,2015,1180,Air Transportation,0,0,0,0,0,0,0,0
0400000US16,16,Idaho,,2015,1200,Water Transport and Terminals       ,0,0,0,0,0,0,0,0
0400000US16,16,Idaho,,2015,1220,Public Welfare,1741,6095212,102,252176,12429,1811,1843,6347388
0400000US16,16,Idaho,,2015,1240,Health,1571,7477954,286,766622,26519,1721,1857,8244576
0400000US16,16,Idaho,,2015,1260,Hospitals,516,1668913,110,164924,12733,588,626,1833837
0400000US16,16,Idaho,,2015,1280,Social Insurance Administration,540,3224494,89,331855,12679,612,629,3556349
0400000US16,16,Idaho,,2015,1300,Solid Waste Management,0,0,0,0,0,0,0,0
0400000US16,16,Idaho,,2015,1320,Sewerage,0,0,0,0,0,0,0,0
0400000US16,16,Idaho,,2015,1340,Parks and Recreation,145,755962,91,128612,7701,189,236,884574
0400000US16,16,Idaho,,2015,1360,Housing and Community Development,0,0,0,0,0,0,0,0
0400000US16,16,Idaho,,2015,1380,Natural Resources,1532,8511769,706,1130263,64588,1895,2238,9642032
0400000US16,16,Idaho,,2015,1400,Water Supply,0,0,0,0,0,0,0,0
0400000US16,16,Idaho,,2015,1420,Electric Power,0,0,0,0,0,0,0,0
0400000US16,16,Idaho,,2015,1440,Gas Supply,0,0,0,0,0,0,0,0
0400000US16,16,Idaho,,2015,1460,Transit,0,0,0,0,0,0,0,0
0400000US16,16,Idaho,,2015,1480,Education Total ,6895,32398309,8360,7239579,375050,9015,15255,39637888
0400000US16,16,Idaho,,2015,1481,Education - Elementary and Secondary Total ,0,0,0,0,0,0,0,0
0400000US16,16,Idaho,,2015,14811,Education - Elementary and Secondary Instructional             ,0,0,0,0,0,0,0,0
0400000US16,16,Idaho,,2015,14812,Education - Elementary and Secondary Other ,0,0,0,0,0,0,0,0
0400000US16,16,Idaho,,2015,1482,Education - Higher Education Total ,6535,30281943,8338,7169418,372839,8643,14873,37451361
0400000US16,16,Idaho,,2015,14821,Education - Higher Education Instructional,2369,13861105,3205,3824841,122217,3061,5574,17685946
0400000US16,16,Idaho,,2015,14822,Education - Higher Education Other ,4166,16420838,5133,3344577,250622,5582,9299,19765415
0400000US16,16,Idaho,,2015,1483,Education - Other,360,2116366,22,70161,2211,372,382,2186527
0400000US16,16,Idaho,,2015,1500,Libraries                          ,0,0,0,0,0,0,0,0
0400000US16,16,Idaho,,2015,1560,State liquor stores,169,745982,171,171880,13419,245,340,917862
0400000US16,16,Idaho,,2015,1580,All other and unallocable,1047,6438095,78,164141,6974,1087,1125,6602236
0400000US17,17,Illinois,,2015,1000,Total - All Government Employment Functions,105040,606592124,51566,88715368,3541123,125501,156606,695307492
0400000US17,17,Illinois,,2015,1020,Financial Administration,4604,23724878,323,606779,32086,4796,4927,24331657
0400000US17,17,Illinois,,2015,1040,Other Government Administration,1978,13212783,34,46734,1759,1988,2012,13259517
0400000US17,17,Illinois,,2015,1060,Judicial and Legal,2555,23220009,28,130928,3135,2574,2583,23350937
0400000US17,17,Illinois,,2015,1100,Police Protection Total,3165,21015610,26,84174,1804,3176,3191,21099784
0400000US17,17,Illinois,,2015,1101,Police Protection - Persons with Power of Arrest       ,1937,13240780,0,0,0,1937,1937,13240780
0400000US17,17,Illinois,,2015,1102,Police Protection - Other ,1228,7774830,26,84174,1804,1239,1254,7859004
0400000US17,17,Illinois,,2015,1120,Fire Protection Total ,0,0,0,0,0,0,0,0
0400000US17,17,Illinois,,2015,1121,Fire Protection - Firefighters,0,0,0,0,0,0,0,0
0400000US17,17,Illinois,,2015,1122,Fire Protection - Other ,0,0,0,0,0,0,0,0
0400000US17,17,Illinois,,2015,1140,Corrections,12284,74539328,0,0,0,12284,12284,74539328
0400000US17,17,Illinois,,2015,1160,Highways,5779,38714554,1395,6202148,156687,6723,7174,44916702
0400000US17,17,Illinois,,2015,1180,Air Transportation,0,0,0,0,0,0,0,0
0400000US17,17,Illinois,,2015,1200,Water Transport and Terminals       ,55,373542,0,0,0,55,55,373542
0400000US17,17,Illinois,,2015,1220,Public Welfare,9516,54949586,25,86030,2060,9529,9541,55035616
0400000US17,17,Illinois,,2015,1240,Health,2371,16067398,18,67638,1369,2379,2389,16135036
0400000US17,17,Illinois,,2015,1260,Hospitals,10712,51945704,603,1620693,41054,10944,11315,53566397
0400000US17,17,Illinois,,2015,1280,Social Insurance Administration,1525,9328322,0,0,0,1525,1525,9328322
0400000US17,17,Illinois,,2015,1300,Solid Waste Management,0,0,0,0,0,0,0,0
0400000US17,17,Illinois,,2015,1320,Sewerage,0,0,0,0,0,0,0,0
0400000US17,17,Illinois,,2015,1340,Parks and Recreation,460,2345406,13,28718,1162,467,473,2374124
0400000US17,17,Illinois,,2015,1360,Housing and Community Development,0,0,0,0,0,0,0,0
0400000US17,17,Illinois,,2015,1380,Natural Resources,2347,12480356,1329,3426048,142816,3156,3676,15906404
0400000US17,17,Illinois,,2015,1400,Water Supply,0,0,0,0,0,0,0,0
0400000US17,17,Illinois,,2015,1420,Electric Power,0,0,0,0,0,0,0,0
0400000US17,17,Illinois,,2015,1440,Gas Supply,0,0,0,0,0,0,0,0
0400000US17,17,Illinois,,2015,1460,Transit,0,0,0,0,0,0,0,0
0400000US17,17,Illinois,,2015,1480,Education Total ,41340,229624797,47462,75408722,3124584,59360,88802,305033519
0400000US17,17,Illinois,,2015,1481,Education - Elementary and Secondary Total ,0,0,0,0,0,0,0,0
0400000US17,17,Illinois,,2015,14811,Education - Elementary and Secondary Instructional             ,0,0,0,0,0,0,0,0
0400000US17,17,Illinois,,2015,14812,Education - Elementary and Secondary Other ,0,0,0,0,0,0,0,0
0400000US17,17,Illinois,,2015,1482,Education - Higher Education Total ,39424,220377190,47440,75338272,3122304,57431,86864,295715462
0400000US17,17,Illinois,,2015,14821,Education - Higher Education Instructional,13124,89404263,17467,35923476,940269,18606,30591,125327739
0400000US17,17,Illinois,,2015,14822,Education - Higher Education Other ,26300,130972927,29973,39414796,2182035,38825,56273,170387723
0400000US17,17,Illinois,,2015,1483,Education - Other,1916,9247607,22,70450,2280,1929,1938,9318057
0400000US17,17,Illinois,,2015,1500,Libraries                          ,0,0,0,0,0,0,0,0
0400000US17,17,Illinois,,2015,1560,State liquor stores,0,0,0,0,0,0,0,0
0400000US17,17,Illinois,,2015,1580,All other and unallocable,6349,35049851,310,1006756,32607,6545,6659,36056607
0400000US18,18,Indiana,,2015,1000,Total - All Government Employment Functions,74536,328927998,42405,35121598,2404949,88229,116941,364049596
0400000US18,18,Indiana,,2015,1020,Financial Administration,1807,8288387,19,31210,1428,1815,1826,8319597
0400000US18,18,Indiana,,2015,1040,Other Government Administration,572,2733304,334,601316,44377,840,906,3334620
0400000US18,18,Indiana,,2015,1060,Judicial and Legal,1434,10145921,64,83190,4108,1458,1498,10229111
0400000US18,18,Indiana,,2015,1100,Police Protection Total,1839,7882855,0,0,0,1839,1839,7882855
0400000US18,18,Indiana,,2015,1101,Police Protection - Persons with Power of Arrest       ,1318,6044694,0,0,0,1318,1318,6044694
0400000US18,18,Indiana,,2015,1102,Police Protection - Other ,521,1838161,0,0,0,521,521,1838161
0400000US18,18,Indiana,,2015,1120,Fire Protection Total ,0,0,0,0,0,0,0,0
0400000US18,18,Indiana,,2015,1121,Fire Protection - Firefighters,0,0,0,0,0,0,0,0
0400000US18,18,Indiana,,2015,1122,Fire Protection - Other ,0,0,0,0,0,0,0,0
0400000US18,18,Indiana,,2015,1140,Corrections,5967,18673400,10,15852,511,5971,5977,18689252
0400000US18,18,Indiana,,2015,1160,Highways,3348,12984397,90,158720,9276,3404,3438,13143117
0400000US18,18,Indiana,,2015,1180,Air Transportation,0,0,0,0,0,0,0,0
0400000US18,18,Indiana,,2015,1200,Water Transport and Terminals       ,33,170518,0,0,0,33,33,170518
0400000US18,18,Indiana,,2015,1220,Public Welfare,5432,17392840,24,20263,1519,5441,5456,17413103
0400000US18,18,Indiana,,2015,1240,Health,1623,6812904,23,24178,720,1627,1646,6837082
0400000US18,18,Indiana,,2015,1260,Hospitals,1815,6018021,23,31590,1823,1825,1838,6049611
0400000US18,18,Indiana,,2015,1280,Social Insurance Administration,1260,3944651,111,126301,10687,1324,1371,4070952
0400000US18,18,Indiana,,2015,1300,Solid Waste Management,0,0,0,0,0,0,0,0
0400000US18,18,Indiana,,2015,1320,Sewerage,0,0,0,0,0,0,0,0
0400000US18,18,Indiana,,2015,1340,Parks and Recreation,133,470757,50,45982,4086,157,183,516739
0400000US18,18,Indiana,,2015,1360,Housing and Community Development,0,0,0,0,0,0,0,0
0400000US18,18,Indiana,,2015,1380,Natural Resources,2105,7655554,283,270748,21372,2230,2388,7926302
0400000US18,18,Indiana,,2015,1400,Water Supply,0,0,0,0,0,0,0,0
0400000US18,18,Indiana,,2015,1420,Electric Power,0,0,0,0,0,0,0,0
0400000US18,18,Indiana,,2015,1440,Gas Supply,0,0,0,0,0,0,0,0
0400000US18,18,Indiana,,2015,1460,Transit,0,0,0,0,0,0,0,0
0400000US18,18,Indiana,,2015,1480,Education Total ,44980,216940775,41047,33525695,2293294,58005,86027,250466470
0400000US18,18,Indiana,,2015,1481,Education - Elementary and Secondary Total ,0,0,0,0,0,0,0,0
0400000US18,18,Indiana,,2015,14811,Education - Elementary and Secondary Instructional             ,0,0,0,0,0,0,0,0
0400000US18,18,Indiana,,2015,14812,Education - Elementary and Secondary Other ,0,0,0,0,0,0,0,0
0400000US18,18,Indiana,,2015,1482,Education - Higher Education Total ,44057,213322425,40878,33408425,2285088,57032,84935,246730850
0400000US18,18,Indiana,,2015,14821,Education - Higher Education Instructional,19518,116837136,11296,18541308,883412,24523,30814,135378444
0400000US18,18,Indiana,,2015,14822,Education - Higher Education Other ,24539,96485289,29582,14867117,1401676,32509,54121,111352406
0400000US18,18,Indiana,,2015,1483,Education - Other,923,3618350,169,117270,8206,973,1092,3735620
0400000US18,18,Indiana,,2015,1500,Libraries                          ,0,0,0,0,0,0,0,0
0400000US18,18,Indiana,,2015,1560,State liquor stores,0,0,0,0,0,0,0,0
0400000US18,18,Indiana,,2015,1580,All other and unallocable,2188,8813714,327,186553,11748,2260,2515,9000267
0400000US19,19,Iowa,,2015,1000,Total - All Government Employment Functions,40670,254559515,28963,24334304,1695744,50255,69633,278893819
0400000US19,19,Iowa,,2015,1020,Financial Administration,1295,7120950,44,139692,5521,1326,1339,7260642
0400000US19,19,Iowa,,2015,1040,Other Government Administration,344,1849126,256,566977,41232,578,600,2416103
0400000US19,19,Iowa,,2015,1060,Judicial and Legal,2227,12407303,88,255629,10587,2287,2315,12662932
0400000US19,19,Iowa,,2015,1100,Police Protection Total,936,5405603,18,17662,852,941,954,5423265
0400000US19,19,Iowa,,2015,1101,Police Protection - Persons with Power of Arrest       ,647,3873920,2,1008,55,647,649,3874928
0400000US19,19,Iowa,,2015,1102,Police Protection - Other ,289,1531683,16,16654,797,294,305,1548337
0400000US19,19,Iowa,,2015,1120,Fire Protection Total ,0,0,0,0,0,0,0,0
0400000US19,19,Iowa,,2015,1121,Fire Protection - Firefighters,0,0,0,0,0,0,0,0
0400000US19,19,Iowa,,2015,1122,Fire Protection - Other ,0,0,0,0,0,0,0,0
0400000US19,19,Iowa,,2015,1140,Corrections,2751,13905308,165,568607,20064,2866,2916,14473915
0400000US19,19,Iowa,,2015,1160,Highways,2153,11256605,161,128349,8253,2200,2314,11384954
0400000US19,19,Iowa,,2015,1180,Air Transportation,0,0,0,0,0,0,0,0
0400000US19,19,Iowa,,2015,1200,Water Transport and Terminals       ,0,0,0,0,0,0,0,0
0400000US19,19,Iowa,,2015,1220,Public Welfare,2617,13366912,60,164836,6590,2654,2677,13531748
0400000US19,19,Iowa,,2015,1240,Health,390,2371542,74,139101,5496,421,464,2510643
0400000US19,19,Iowa,,2015,1260,Hospitals,6902,42561554,4717,2991900,185046,7948,11619,45553454
0400000US19,19,Iowa,,2015,1280,Social Insurance Administration,552,2782509,1,4761,89,553,553,2787270
0400000US19,19,Iowa,,2015,1300,Solid Waste Management,0,0,0,0,0,0,0,0
0400000US19,19,Iowa,,2015,1320,Sewerage,0,0,0,0,0,0,0,0
0400000US19,19,Iowa,,2015,1340,Parks and Recreation,98,572158,11,13939,1523,107,109,586097
0400000US19,19,Iowa,,2015,1360,Housing and Community Development,88,591615,4,11928,423,90,92,603543
0400000US19,19,Iowa,,2015,1380,Natural Resources,1527,8393568,168,226925,15147,1612,1695,8620493
0400000US19,19,Iowa,,2015,1400,Water Supply,0,0,0,0,0,0,0,0
0400000US19,19,Iowa,,2015,1420,Electric Power,0,0,0,0,0,0,0,0
0400000US19,19,Iowa,,2015,1440,Gas Supply,0,0,0,0,0,0,0,0
0400000US19,19,Iowa,,2015,1460,Transit,0,0,0,0,0,0,0,0
0400000US19,19,Iowa,,2015,1480,Education Total ,16426,119092809,22908,18364008,1361312,24117,39334,137456817
0400000US19,19,Iowa,,2015,1481,Education - Elementary and Secondary Total ,0,0,0,0,0,0,0,0
0400000US19,19,Iowa,,2015,14811,Education - Elementary and Secondary Instructional             ,0,0,0,0,0,0,0,0
0400000US19,19,Iowa,,2015,14812,Education - Elementary and Secondary Other ,0,0,0,0,0,0,0,0
0400000US19,19,Iowa,,2015,1482,Education - Higher Education Total ,15439,113511708,22801,18041687,1351986,23077,38240,131553395
0400000US19,19,Iowa,,2015,14821,Education - Higher Education Instructional,3709,37789073,6592,11515762,430468,6141,10301,49304835
0400000US19,19,Iowa,,2015,14822,Education - Higher Education Other ,11730,75722635,16209,6525925,921518,16936,27939,82248560
0400000US19,19,Iowa,,2015,1483,Education - Other,987,5581101,107,322321,9326,1040,1094,5903422
0400000US19,19,Iowa,,2015,1500,Libraries                          ,0,0,0,0,0,0,0,0
0400000US19,19,Iowa,,2015,1560,State liquor stores,0,0,0,0,0,0,0,0
0400000US19,19,Iowa,,2015,1580,All other and unallocable,2364,12881953,288,739990,33609,2555,2652,13621943
0400000US20,20,Kansas,,2015,1000,Total - All Government Employment Functions,45875,206609285,18025,19401696,993462,51540,63900,226010981
0400000US20,20,Kansas,,2015,1020,Financial Administration,1755,6937870,46,65551,3403,1774,1801,7003421
0400000US20,20,Kansas,,2015,1040,Other Government Administration,464,1513598,182,452441,19245,573,646,1966039
0400000US20,20,Kansas,,2015,1060,Judicial and Legal,2050,8918251,112,143609,7899,2095,2162,9061860
0400000US20,20,Kansas,,2015,1100,Police Protection Total,983,4405806,66,100026,5554,1014,1049,4505832
0400000US20,20,Kansas,,2015,1101,Police Protection - Persons with Power of Arrest       ,279,1479860,22,44767,2148,291,301,1524627
0400000US20,20,Kansas,,2015,1102,Police Protection - Other ,704,2925946,44,55259,3406,723,748,2981205
0400000US20,20,Kansas,,2015,1120,Fire Protection Total ,0,0,0,0,0,0,0,0
0400000US20,20,Kansas,,2015,1121,Fire Protection - Firefighters,0,0,0,0,0,0,0,0
0400000US20,20,Kansas,,2015,1122,Fire Protection - Other ,0,0,0,0,0,0,0,0
0400000US20,20,Kansas,,2015,1140,Corrections,3420,10765196,14,17191,1227,3427,3434,10782387
0400000US20,20,Kansas,,2015,1160,Highways,2768,10442870,191,167555,11647,2834,2959,10610425
0400000US20,20,Kansas,,2015,1180,Air Transportation,0,0,0,0,0,0,0,0
0400000US20,20,Kansas,,2015,1200,Water Transport and Terminals       ,0,0,0,0,0,0,0,0
0400000US20,20,Kansas,,2015,1220,Public Welfare,2909,9926444,61,56810,5807,2942,2970,9983254
0400000US20,20,Kansas,,2015,1240,Health,1013,4145473,33,60040,2765,1028,1046,4205513
0400000US20,20,Kansas,,2015,1260,Hospitals,8415,38521455,1800,4416521,154682,9346,10215,42937976
0400000US20,20,Kansas,,2015,1280,Social Insurance Administration,96,342957,1,206,33,96,97,343163
0400000US20,20,Kansas,,2015,1300,Solid Waste Management,0,0,0,0,0,0,0,0
0400000US20,20,Kansas,,2015,1320,Sewerage,0,0,0,0,0,0,0,0
0400000US20,20,Kansas,,2015,1340,Parks and Recreation,554,1638698,1,518,42,554,555,1639216
0400000US20,20,Kansas,,2015,1360,Housing and Community Development,0,0,0,0,0,0,0,0
0400000US20,20,Kansas,,2015,1380,Natural Resources,760,3245113,110,111334,8491,807,870,3356447
0400000US20,20,Kansas,,2015,1400,Water Supply,0,0,0,0,0,0,0,0
0400000US20,20,Kansas,,2015,1420,Electric Power,0,0,0,0,0,0,0,0
0400000US20,20,Kansas,,2015,1440,Gas Supply,0,0,0,0,0,0,0,0
0400000US20,20,Kansas,,2015,1460,Transit,0,0,0,0,0,0,0,0
0400000US20,20,Kansas,,2015,1480,Education Total ,18642,97306203,15209,13600630,762994,22952,33851,110906833
0400000US20,20,Kansas,,2015,1481,Education - Elementary and Secondary Total ,0,0,0,0,0,0,0,0
0400000US20,20,Kansas,,2015,14811,Education - Elementary and Secondary Instructional             ,0,0,0,0,0,0,0,0
0400000US20,20,Kansas,,2015,14812,Education - Elementary and Secondary Other ,0,0,0,0,0,0,0,0
0400000US20,20,Kansas,,2015,1482,Education - Higher Education Total ,18044,94731662,15127,13498049,758393,22328,33171,108229711
0400000US20,20,Kansas,,2015,14821,Education - Higher Education Instructional,6660,47539771,4111,6977647,253062,8090,10771,54517418
0400000US20,20,Kansas,,2015,14822,Education - Higher Education Other ,11384,47191891,11016,6520402,505331,14238,22400,53712293
0400000US20,20,Kansas,,2015,1483,Education - Other,598,2574541,82,102581,4601,624,680,2677122
0400000US20,20,Kansas,,2015,1500,Libraries                          ,0,0,0,0,0,0,0,0
0400000US20,20,Kansas,,2015,1560,State liquor stores,0,0,0,0,0,0,0,0
0400000US20,20,Kansas,,2015,1580,All other and unallocable,2046,8499351,199,209264,9673,2098,2245,8708615
0400000US21,21,Kentucky,,2015,1000,Total - All Government Employment Functions,74129,321268649,25425,28012058,1867799,85091,99554,349280707
0400000US21,21,Kentucky,,2015,1020,Financial Administration,2534,9889975,20,28168,825,2539,2554,9918143
0400000US21,21,Kentucky,,2015,1040,Other Government Administration,803,3987174,383,869056,36243,1020,1186,4856230
0400000US21,21,Kentucky,,2015,1060,Judicial and Legal,5467,19544964,190,291775,18445,5577,5657,19836739
0400000US21,21,Kentucky,,2015,1100,Police Protection Total,2074,7813042,4,5792,305,2076,2078,7818834
0400000US21,21,Kentucky,,2015,1101,Police Protection - Persons with Power of Arrest       ,1054,3921758,0,0,0,1054,1054,3921758
0400000US21,21,Kentucky,,2015,1102,Police Protection - Other ,1020,3891284,4,5792,305,1022,1024,3897076
0400000US21,21,Kentucky,,2015,1120,Fire Protection Total ,0,0,0,0,0,0,0,0
0400000US21,21,Kentucky,,2015,1121,Fire Protection - Firefighters,0,0,0,0,0,0,0,0
0400000US21,21,Kentucky,,2015,1122,Fire Protection - Other ,0,0,0,0,0,0,0,0
0400000US21,21,Kentucky,,2015,1140,Corrections,4232,11392428,10,10152,582,4236,4242,11402580
0400000US21,21,Kentucky,,2015,1160,Highways,4549,17361038,18,30832,1192,4556,4567,17391870
0400000US21,21,Kentucky,,2015,1180,Air Transportation,30,123757,0,0,0,30,30,123757
0400000US21,21,Kentucky,,2015,1200,Water Transport and Terminals       ,0,0,0,0,0,0,0,0
0400000US21,21,Kentucky,,2015,1220,Public Welfare,7267,22256959,28,48692,1976,7280,7295,22305651
0400000US21,21,Kentucky,,2015,1240,Health,3495,14851705,84,121865,5013,3524,3579,14973570
0400000US21,21,Kentucky,,2015,1260,Hospitals,5801,26780696,873,1783069,71038,6202,6674,28563765
0400000US21,21,Kentucky,,2015,1280,Social Insurance Administration,1294,3936874,23,36639,1558,1304,1317,3973513
0400000US21,21,Kentucky,,2015,1300,Solid Waste Management,0,0,0,0,0,0,0,0
0400000US21,21,Kentucky,,2015,1320,Sewerage,0,0,0,0,0,0,0,0
0400000US21,21,Kentucky,,2015,1340,Parks and Recreation,1058,2548627,4,4084,336,1060,1062,2552711
0400000US21,21,Kentucky,,2015,1360,Housing and Community Development,0,0,0,0,0,0,0,0
0400000US21,21,Kentucky,,2015,1380,Natural Resources,2569,9245601,121,203983,8694,2619,2690,9449584
0400000US21,21,Kentucky,,2015,1400,Water Supply,0,0,0,0,0,0,0,0
0400000US21,21,Kentucky,,2015,1420,Electric Power,0,0,0,0,0,0,0,0
0400000US21,21,Kentucky,,2015,1440,Gas Supply,0,0,0,0,0,0,0,0
0400000US21,21,Kentucky,,2015,1460,Transit,0,0,0,0,0,0,0,0
0400000US21,21,Kentucky,,2015,1480,Education Total ,30339,161862218,23460,24468985,1717807,40430,53799,186331203
0400000US21,21,Kentucky,,2015,1481,Education - Elementary and Secondary Total ,0,0,0,0,0,0,0,0
0400000US21,21,Kentucky,,2015,14811,Education - Elementary and Secondary Instructional             ,0,0,0,0,0,0,0,0
0400000US21,21,Kentucky,,2015,14812,Education - Elementary and Secondary Other ,0,0,0,0,0,0,0,0
0400000US21,21,Kentucky,,2015,1482,Education - Higher Education Total ,28223,152854810,23105,24223661,1706442,38245,51328,177078471
0400000US21,21,Kentucky,,2015,14821,Education - Higher Education Instructional,9320,74547130,7336,11332244,520920,12384,16656,85879374
0400000US21,21,Kentucky,,2015,14822,Education - Higher Education Other ,18903,78307680,15769,12891417,1185522,25861,34672,91199097
0400000US21,21,Kentucky,,2015,1483,Education - Other,2116,9007408,355,245324,11365,2185,2471,9252732
0400000US21,21,Kentucky,,2015,1500,Libraries                          ,0,0,0,0,0,0,0,0
0400000US21,21,Kentucky,,2015,1560,State liquor stores,0,0,0,0,0,0,0,0
0400000US21,21,Kentucky,,2015,1580,All other and unallocable,2617,9673591,207,108966,3785,2638,2824,9782557
0400000US22,22,Louisiana,,2015,1000,Total - All Government Employment Functions,67578,310594517,21039,20625626,1335806,75267,88617,331220143
0400000US22,22,Louisiana,,2015,1020,Financial Administration,2600,12682704,174,257748,15318,2686,2774,12940452
0400000US22,22,Louisiana,,2015,1040,Other Government Administration,1809,8275002,391,583768,34526,2005,2200,8858770
0400000US22,22,Louisiana,,2015,1060,Judicial and Legal,1643,7427454,49,62738,2750,1658,1692,7490192
0400000US22,22,Louisiana,,2015,1100,Police Protection Total,1676,11139015,58,176114,7380,1717,1734,11315129
0400000US22,22,Louisiana,,2015,1101,Police Protection - Persons with Power of Arrest       ,1133,8477140,30,98221,3778,1154,1163,8575361
0400000US22,22,Louisiana,,2015,1102,Police Protection - Other ,543,2661875,28,77893,3602,563,571,2739768
0400000US22,22,Louisiana,,2015,1120,Fire Protection Total ,0,0,0,0,0,0,0,0
0400000US22,22,Louisiana,,2015,1121,Fire Protection - Firefighters,0,0,0,0,0,0,0,0
0400000US22,22,Louisiana,,2015,1122,Fire Protection - Other ,0,0,0,0,0,0,0,0
0400000US22,22,Louisiana,,2015,1140,Corrections,5751,23190792,104,164094,10582,5811,5855,23354886
0400000US22,22,Louisiana,,2015,1160,Highways,4339,18699969,42,62529,3463,4358,4381,18762498
0400000US22,22,Louisiana,,2015,1180,Air Transportation,0,0,0,0,0,0,0,0
0400000US22,22,Louisiana,,2015,1200,Water Transport and Terminals       ,276,1565418,5,27501,441,278,281,1592919
0400000US22,22,Louisiana,,2015,1220,Public Welfare,5421,20022973,155,192500,11029,5484,5576,20215473
0400000US22,22,Louisiana,,2015,1240,Health,3610,17769636,143,314904,10278,3667,3753,18084540
0400000US22,22,Louisiana,,2015,1260,Hospitals,9244,36941660,1023,1562711,110539,9868,10267,38504371
0400000US22,22,Louisiana,,2015,1280,Social Insurance Administration,1025,3993482,36,36649,3025,1042,1061,4030131
0400000US22,22,Louisiana,,2015,1300,Solid Waste Management,0,0,0,0,0,0,0,0
0400000US22,22,Louisiana,,2015,1320,Sewerage,0,0,0,0,0,0,0,0
0400000US22,22,Louisiana,,2015,1340,Parks and Recreation,821,3093851,205,262922,19015,929,1026,3356773
0400000US22,22,Louisiana,,2015,1360,Housing and Community Development,0,0,0,0,0,0,0,0
0400000US22,22,Louisiana,,2015,1380,Natural Resources,3657,16377312,748,764435,50993,3959,4405,17141747
0400000US22,22,Louisiana,,2015,1400,Water Supply,0,0,0,0,0,0,0,0
0400000US22,22,Louisiana,,2015,1420,Electric Power,0,0,0,0,0,0,0,0
0400000US22,22,Louisiana,,2015,1440,Gas Supply,0,0,0,0,0,0,0,0
0400000US22,22,Louisiana,,2015,1460,Transit,0,0,0,0,0,0,0,0
0400000US22,22,Louisiana,,2015,1480,Education Total ,23373,119025672,17726,15997236,1047540,29423,41099,135022908
0400000US22,22,Louisiana,,2015,1481,Education - Elementary and Secondary Total ,98,520142,12,32712,1293,105,110,552854
0400000US22,22,Louisiana,,2015,14811,Education - Elementary and Secondary Instructional             ,98,520142,12,32712,1293,105,110,552854
0400000US22,22,Louisiana,,2015,14812,Education - Elementary and Secondary Other ,0,0,0,0,0,0,0,0
0400000US22,22,Louisiana,,2015,1482,Education - Higher Education Total ,21072,107871336,17167,15183606,1012113,26921,38239,123054942
0400000US22,22,Louisiana,,2015,14821,Education - Higher Education Instructional,7265,53107333,5422,7868980,381204,9467,12687,60976313
0400000US22,22,Louisiana,,2015,14822,Education - Higher Education Other ,13807,54764003,11745,7314626,630909,17454,25552,62078629
0400000US22,22,Louisiana,,2015,1483,Education - Other,2203,10634194,547,780918,34134,2397,2750,11415112
0400000US22,22,Louisiana,,2015,1500,Libraries                          ,0,0,0,0,0,0,0,0
0400000US22,22,Louisiana,,2015,1560,State liquor stores,0,0,0,0,0,0,0,0
0400000US22,22,Louisiana,,2015,1580,All other and unallocable,2333,10389577,180,159777,8927,2382,2513,10549354
0400000US23,23,Maine,,2015,1000,Total - All Government Employment Functions,18362,79364440,8118,8860128,466945,21004,26480,88224568
0400000US23,23,Maine,,2015,1020,Financial Administration,1233,4937934,44,164897,5835,1267,1277,5102831
0400000US23,23,Maine,,2015,1040,Other Government Administration,252,1271476,226,666655,27393,408,478,1938131
0400000US23,23,Maine,,2015,1060,Judicial and Legal,672,3352524,123,321296,13232,747,795,3673820
0400000US23,23,Maine,,2015,1100,Police Protection Total,537,2778721,0,0,0,537,537,2778721
0400000US23,23,Maine,,2015,1101,Police Protection - Persons with Power of Arrest       ,318,1896815,0,0,0,318,318,1896815
0400000US23,23,Maine,,2015,1102,Police Protection - Other ,219,881906,0,0,0,219,219,881906
0400000US23,23,Maine,,2015,1120,Fire Protection Total ,0,0,0,0,0,0,0,0
0400000US23,23,Maine,,2015,1121,Fire Protection - Firefighters,0,0,0,0,0,0,0,0
0400000US23,23,Maine,,2015,1122,Fire Protection - Other ,0,0,0,0,0,0,0,0
0400000US23,23,Maine,,2015,1140,Corrections,1105,4315079,95,322119,12258,1175,1200,4637198
0400000US23,23,Maine,,2015,1160,Highways,1952,7992341,121,213942,11109,2015,2073,8206283
0400000US23,23,Maine,,2015,1180,Air Transportation,0,0,0,0,0,0,0,0
0400000US23,23,Maine,,2015,1200,Water Transport and Terminals       ,65,258620,21,44813,2925,82,86,303433
0400000US23,23,Maine,,2015,1220,Public Welfare,2785,10590488,48,107949,4083,2808,2833,10698437
0400000US23,23,Maine,,2015,1240,Health,961,4147946,16,61916,1758,971,977,4209862
0400000US23,23,Maine,,2015,1260,Hospitals,447,1996535,51,117247,5148,476,498,2113782
0400000US23,23,Maine,,2015,1280,Social Insurance Administration,394,1435808,1,4057,120,395,395,1439865
0400000US23,23,Maine,,2015,1300,Solid Waste Management,0,0,0,0,0,0,0,0
0400000US23,23,Maine,,2015,1320,Sewerage,0,0,0,0,0,0,0,0
0400000US23,23,Maine,,2015,1340,Parks and Recreation,167,609826,1,2593,97,168,168,612419
0400000US23,23,Maine,,2015,1360,Housing and Community Development,0,0,0,0,0,0,0,0
0400000US23,23,Maine,,2015,1380,Natural Resources,1076,4845316,186,301133,15451,1163,1262,5146449
0400000US23,23,Maine,,2015,1400,Water Supply,0,0,0,0,0,0,0,0
0400000US23,23,Maine,,2015,1420,Electric Power,0,0,0,0,0,0,0,0
0400000US23,23,Maine,,2015,1440,Gas Supply,0,0,0,0,0,0,0,0
0400000US23,23,Maine,,2015,1460,Transit,0,0,0,0,0,0,0,0
0400000US23,23,Maine,,2015,1480,Education Total ,5461,24874614,7076,6166735,354313,7461,12537,31041349
0400000US23,23,Maine,,2015,1481,Education - Elementary and Secondary Total ,16,53126,33,35951,2641,31,49,89077
0400000US23,23,Maine,,2015,14811,Education - Elementary and Secondary Instructional             ,11,43031,15,20018,1332,19,26,63049
0400000US23,23,Maine,,2015,14812,Education - Elementary and Secondary Other ,5,10095,18,15933,1309,12,23,26028
0400000US23,23,Maine,,2015,1482,Education - Higher Education Total ,5213,23860048,7043,6130784,351672,7198,12256,29990832
0400000US23,23,Maine,,2015,14821,Education - Higher Education Instructional,1620,10000461,2411,3387890,132071,2366,4031,13388351
0400000US23,23,Maine,,2015,14822,Education - Higher Education Other ,3593,13859587,4632,2742894,219601,4832,8225,16602481
0400000US23,23,Maine,,2015,1483,Education - Other,232,961440,0,0,0,232,232,961440
0400000US23,23,Maine,,2015,1500,Libraries                          ,0,0,0,0,0,0,0,0
0400000US23,23,Maine,,2015,1560,State liquor stores,0,0,12,46717,1692,10,12,46717
0400000US23,23,Maine,,2015,1580,All other and unallocable,1255,5957212,97,318059,11531,1321,1352,6275271
0400000US24,24,Maryland,,2015,1000,Total - All Government Employment Functions,78487,409465425,13565,40269015,1577629,87404,92052,449734440
0400000US24,24,Maryland,,2015,1020,Financial Administration,2939,14167293,124,353244,15388,3028,3063,14520537
0400000US24,24,Maryland,,2015,1040,Other Government Administration,1428,8360983,258,563947,17690,1528,1686,8924930
0400000US24,24,Maryland,,2015,1060,Judicial and Legal,4771,29084982,480,1303150,69934,5167,5251,30388132
0400000US24,24,Maryland,,2015,1100,Police Protection Total,2296,13198503,0,0,0,2296,2296,13198503
0400000US24,24,Maryland,,2015,1101,Police Protection - Persons with Power of Arrest       ,1508,9575103,0,0,0,1508,1508,9575103
0400000US24,24,Maryland,,2015,1102,Police Protection - Other ,788,3623400,0,0,0,788,788,3623400
0400000US24,24,Maryland,,2015,1120,Fire Protection Total ,0,0,0,0,0,0,0,0
0400000US24,24,Maryland,,2015,1121,Fire Protection - Firefighters,0,0,0,0,0,0,0,0
0400000US24,24,Maryland,,2015,1122,Fire Protection - Other ,0,0,0,0,0,0,0,0
0400000US24,24,Maryland,,2015,1140,Corrections,12148,58689849,528,1314573,78403,12591,12676,60004422
0400000US24,24,Maryland,,2015,1160,Highways,4542,24789006,0,0,0,4542,4542,24789006
0400000US24,24,Maryland,,2015,1180,Air Transportation,475,2749226,0,0,0,475,475,2749226
0400000US24,24,Maryland,,2015,1200,Water Transport and Terminals       ,274,1776424,0,0,0,274,274,1776424
0400000US24,24,Maryland,,2015,1220,Public Welfare,6481,28377009,251,714010,37686,6694,6732,29091019
0400000US24,24,Maryland,,2015,1240,Health,5560,27784643,815,1765957,97365,6110,6375,29550600
0400000US24,24,Maryland,,2015,1260,Hospitals,3427,16330552,481,947613,39831,3651,3908,17278165
0400000US24,24,Maryland,,2015,1280,Social Insurance Administration,869,4132030,131,376198,19681,980,1000,4508228
0400000US24,24,Maryland,,2015,1300,Solid Waste Management,0,0,0,0,0,0,0,0
0400000US24,24,Maryland,,2015,1320,Sewerage,0,0,0,0,0,0,0,0
0400000US24,24,Maryland,,2015,1340,Parks and Recreation,361,1725396,86,140651,7595,404,447,1866047
0400000US24,24,Maryland,,2015,1360,Housing and Community Development,0,0,0,0,0,0,0,0
0400000US24,24,Maryland,,2015,1380,Natural Resources,1836,9915754,319,816643,41736,2073,2155,10732397
0400000US24,24,Maryland,,2015,1400,Water Supply,0,0,0,0,0,0,0,0
0400000US24,24,Maryland,,2015,1420,Electric Power,0,0,0,0,0,0,0,0
0400000US24,24,Maryland,,2015,1440,Gas Supply,0,0,0,0,0,0,0,0
0400000US24,24,Maryland,,2015,1460,Transit,724,4441058,0,0,0,724,724,4441058
0400000US24,24,Maryland,,2015,1480,Education Total ,24322,132646323,9563,30504918,1088176,30469,33885,163151241
0400000US24,24,Maryland,,2015,1481,Education - Elementary and Secondary Total ,0,0,0,0,0,0,0,0
0400000US24,24,Maryland,,2015,14811,Education - Elementary and Secondary Instructional             ,0,0,0,0,0,0,0,0
0400000US24,24,Maryland,,2015,14812,Education - Elementary and Secondary Other ,0,0,0,0,0,0,0,0
0400000US24,24,Maryland,,2015,1482,Education - Higher Education Total ,22505,122979679,9229,29389798,1044406,28405,31734,152369477
0400000US24,24,Maryland,,2015,14821,Education - Higher Education Instructional,7155,54790120,4631,23202185,650936,10832,11786,77992305
0400000US24,24,Maryland,,2015,14822,Education - Higher Education Other ,15350,68189559,4598,6187613,393470,17573,19948,74377172
0400000US24,24,Maryland,,2015,1483,Education - Other,1817,9666644,334,1115120,43770,2064,2151,10781764
0400000US24,24,Maryland,,2015,1500,Libraries                          ,0,0,0,0,0,0,0,0
0400000US24,24,Maryland,,2015,1560,State liquor stores,0,0,0,0,0,0,0,0
0400000US24,24,Maryland,,2015,1580,All other and unallocable,6034,31296394,529,1468111,64144,6398,6563,32764505
0400000US25,25,Massachusetts,,2015,1000,Total - All Government Employment Functions,89843,517472276,35722,55525181,2077471,102222,125565,572997457
0400000US25,25,Massachusetts,,2015,1020,Financial Administration,3953,22856593,270,884987,12714,4031,4223,23741580
0400000US25,25,Massachusetts,,2015,1040,Other Government Administration,1997,9904392,73,210866,4082,2022,2070,10115258
0400000US25,25,Massachusetts,,2015,1060,Judicial and Legal,9092,54751331,315,1057988,18184,9202,9407,55809319
0400000US25,25,Massachusetts,,2015,1100,Police Protection Total,2855,26832244,33,132634,2920,2871,2888,26964878
0400000US25,25,Massachusetts,,2015,1101,Police Protection - Persons with Power of Arrest       ,2022,21753971,0,0,0,2022,2022,21753971
0400000US25,25,Massachusetts,,2015,1102,Police Protection - Other ,833,5078273,33,132634,2920,849,866,5210907
0400000US25,25,Massachusetts,,2015,1120,Fire Protection Total ,0,0,0,0,0,0,0,0
0400000US25,25,Massachusetts,,2015,1121,Fire Protection - Firefighters,0,0,0,0,0,0,0,0
0400000US25,25,Massachusetts,,2015,1122,Fire Protection - Other ,0,0,0,0,0,0,0,0
0400000US25,25,Massachusetts,,2015,1140,Corrections,12445,68403498,110,366841,5710,12481,12555,68770339
0400000US25,25,Massachusetts,,2015,1160,Highways,3145,18767316,66,255726,5538,3178,3211,19023042
0400000US25,25,Massachusetts,,2015,1180,Air Transportation,1012,7100767,0,0,0,1012,1012,7100767
0400000US25,25,Massachusetts,,2015,1200,Water Transport and Terminals       ,160,1117444,0,0,0,160,160,1117444
0400000US25,25,Massachusetts,,2015,1220,Public Welfare,7213,39927039,427,1494969,23722,7357,7640,41422008
0400000US25,25,Massachusetts,,2015,1240,Health,6628,36109908,830,2491110,60296,6992,7458,38601018
0400000US25,25,Massachusetts,,2015,1260,Hospitals,5820,25331987,727,2169214,57271,6152,6547,27501201
0400000US25,25,Massachusetts,,2015,1280,Social Insurance Administration,1422,7608078,44,195304,3078,1441,1466,7803382
0400000US25,25,Massachusetts,,2015,1300,Solid Waste Management,0,0,0,0,0,0,0,0
0400000US25,25,Massachusetts,,2015,1320,Sewerage,805,5526149,35,202290,2801,822,840,5728439
0400000US25,25,Massachusetts,,2015,1340,Parks and Recreation,904,4623393,149,171900,10726,966,1053,4795293
0400000US25,25,Massachusetts,,2015,1360,Housing and Community Development,0,0,0,0,0,0,0,0
0400000US25,25,Massachusetts,,2015,1380,Natural Resources,1111,7143165,116,420822,5681,1146,1227,7563987
0400000US25,25,Massachusetts,,2015,1400,Water Supply,484,2987412,18,39682,665,488,502,3027094
0400000US25,25,Massachusetts,,2015,1420,Electric Power,0,0,0,0,0,0,0,0
0400000US25,25,Massachusetts,,2015,1440,Gas Supply,0,0,0,0,0,0,0,0
0400000US25,25,Massachusetts,,2015,1460,Transit,0,0,0,0,0,0,0,0
0400000US25,25,Massachusetts,,2015,1480,Education Total ,26384,150105800,32271,44469593,1848517,37394,58655,194575393
0400000US25,25,Massachusetts,,2015,1481,Education - Elementary and Secondary Total ,2476,11524406,134,159525,7719,2522,2610,11683931
0400000US25,25,Massachusetts,,2015,14811,Education - Elementary and Secondary Instructional             ,1901,9137991,15,16592,407,1903,1916,9154583
0400000US25,25,Massachusetts,,2015,14812,Education - Elementary and Secondary Other ,575,2386415,119,142933,7312,619,694,2529348
0400000US25,25,Massachusetts,,2015,1482,Education - Higher Education Total ,22799,131564803,32033,43950677,1835302,33730,54832,175515480
0400000US25,25,Massachusetts,,2015,14821,Education - Higher Education Instructional,6705,48341974,12973,25435464,817614,11623,19678,73777438
0400000US25,25,Massachusetts,,2015,14822,Education - Higher Education Other ,16094,83222829,19060,18515213,1017688,22107,35154,101738042
0400000US25,25,Massachusetts,,2015,1483,Education - Other,1109,7016591,104,359391,5496,1142,1213,7375982
0400000US25,25,Massachusetts,,2015,1500,Libraries                          ,0,0,0,0,0,0,0,0
0400000US25,25,Massachusetts,,2015,1560,State liquor stores,0,0,0,0,0,0,0,0
0400000US25,25,Massachusetts,,2015,1580,All other and unallocable,4413,28375760,238,961255,15566,4507,4651,29337015
0400000US26,26,Michigan,,2015,1000,Total - All Government Employment Functions,113456,650804098,72108,117651954,5084895,142292,185564,768456052
0400000US26,26,Michigan,,2015,1020,Financial Administration,3902,22558950,448,2020488,51062,4191,4350,24579438
0400000US26,26,Michigan,,2015,1040,Other Government Administration,1460,7451835,27,98491,3448,1479,1487,7550326
0400000US26,26,Michigan,,2015,1060,Judicial and Legal,1428,10154847,61,195050,6543,1465,1489,10349897
0400000US26,26,Michigan,,2015,1100,Police Protection Total,2753,14521858,30,73300,2403,2767,2783,14595158
0400000US26,26,Michigan,,2015,1101,Police Protection - Persons with Power of Arrest       ,2027,11474823,0,0,0,2027,2027,11474823
0400000US26,26,Michigan,,2015,1102,Police Protection - Other ,726,3047035,30,73300,2403,740,756,3120335
0400000US26,26,Michigan,,2015,1120,Fire Protection Total ,0,0,0,0,0,0,0,0
0400000US26,26,Michigan,,2015,1121,Fire Protection - Firefighters,0,0,0,0,0,0,0,0
0400000US26,26,Michigan,,2015,1122,Fire Protection - Other ,0,0,0,0,0,0,0,0
0400000US26,26,Michigan,,2015,1140,Corrections,12244,61060581,168,787149,23653,12378,12412,61847730
0400000US26,26,Michigan,,2015,1160,Highways,2380,13071243,108,339127,13718,2458,2488,13410370
0400000US26,26,Michigan,,2015,1180,Air Transportation,0,0,0,0,0,0,0,0
0400000US26,26,Michigan,,2015,1200,Water Transport and Terminals       ,0,0,0,0,0,0,0,0
0400000US26,26,Michigan,,2015,1220,Public Welfare,10725,51470682,561,2097024,91308,11240,11286,53567706
0400000US26,26,Michigan,,2015,1240,Health,4975,24153203,946,3888060,107846,5585,5921,28041263
0400000US26,26,Michigan,,2015,1260,Hospitals,12296,66437022,6098,24869904,730219,16421,18394,91306926
0400000US26,26,Michigan,,2015,1280,Social Insurance Administration,727,3762696,62,235093,10671,787,789,3997789
0400000US26,26,Michigan,,2015,1300,Solid Waste Management,0,0,0,0,0,0,0,0
0400000US26,26,Michigan,,2015,1320,Sewerage,0,0,0,0,0,0,0,0
0400000US26,26,Michigan,,2015,1340,Parks and Recreation,165,846528,83,248649,9475,219,248,1095177
0400000US26,26,Michigan,,2015,1360,Housing and Community Development,278,1623193,48,115276,5777,311,326,1738469
0400000US26,26,Michigan,,2015,1380,Natural Resources,2942,15039555,568,1116886,60349,3283,3510,16156441
0400000US26,26,Michigan,,2015,1400,Water Supply,0,0,0,0,0,0,0,0
0400000US26,26,Michigan,,2015,1420,Electric Power,0,0,0,0,0,0,0,0
0400000US26,26,Michigan,,2015,1440,Gas Supply,0,0,0,0,0,0,0,0
0400000US26,26,Michigan,,2015,1460,Transit,0,0,0,0,0,0,0,0
0400000US26,26,Michigan,,2015,1480,Education Total ,53349,339123950,62256,79863401,3886680,75415,115605,418987351
0400000US26,26,Michigan,,2015,1481,Education - Elementary and Secondary Total ,0,0,0,0,0,0,0,0
0400000US26,26,Michigan,,2015,14811,Education - Elementary and Secondary Instructional             ,0,0,0,0,0,0,0,0
0400000US26,26,Michigan,,2015,14812,Education - Elementary and Secondary Other ,0,0,0,0,0,0,0,0
0400000US26,26,Michigan,,2015,1482,Education - Higher Education Total ,52802,335858435,62165,79475359,3871981,74785,114967,415333794
0400000US26,26,Michigan,,2015,14821,Education - Higher Education Instructional,16845,160098566,13842,40903889,1523265,25510,30687,201002455
0400000US26,26,Michigan,,2015,14822,Education - Higher Education Other ,35957,175759869,48323,38571470,2348716,49275,84280,214331339
0400000US26,26,Michigan,,2015,1483,Education - Other,547,3265515,91,388042,14699,630,638,3653557
0400000US26,26,Michigan,,2015,1500,Libraries                          ,0,0,0,0,0,0,0,0
0400000US26,26,Michigan,,2015,1560,State liquor stores,0,0,0,0,0,0,0,0
0400000US26,26,Michigan,,2015,1580,All other and unallocable,3832,19527955,644,1704056,81743,4293,4476,21232011
0400000US27,27,Minnesota,,2015,1000,Total - All Government Employment Functions,68386,392068396,34811,51256748,2458804,82277,103197,443325144
0400000US27,27,Minnesota,,2015,1020,Financial Administration,4598,28445851,148,512572,22160,4722,4746,28958423
0400000US27,27,Minnesota,,2015,1040,Other Government Administration,913,5375570,143,461822,22129,1038,1056,5837392
0400000US27,27,Minnesota,,2015,1060,Judicial and Legal,3468,18925488,464,1579281,61032,3812,3932,20504769
0400000US27,27,Minnesota,,2015,1100,Police Protection Total,920,4813308,28,63065,2976,937,948,4876373
0400000US27,27,Minnesota,,2015,1101,Police Protection - Persons with Power of Arrest       ,518,3166650,0,0,0,518,518,3166650
0400000US27,27,Minnesota,,2015,1102,Police Protection - Other ,402,1646658,28,63065,2976,419,430,1709723
0400000US27,27,Minnesota,,2015,1120,Fire Protection Total ,0,0,0,0,0,0,0,0
0400000US27,27,Minnesota,,2015,1121,Fire Protection - Firefighters,0,0,0,0,0,0,0,0
0400000US27,27,Minnesota,,2015,1122,Fire Protection - Other ,0,0,0,0,0,0,0,0
0400000US27,27,Minnesota,,2015,1140,Corrections,4082,19394302,148,525877,24322,4219,4230,19920179
0400000US27,27,Minnesota,,2015,1160,Highways,4419,22964063,169,307210,14056,4498,4588,23271273
0400000US27,27,Minnesota,,2015,1180,Air Transportation,0,0,0,0,0,0,0,0
0400000US27,27,Minnesota,,2015,1200,Water Transport and Terminals       ,0,0,0,0,0,0,0,0
0400000US27,27,Minnesota,,2015,1220,Public Welfare,1663,8333555,1228,3492746,240390,3022,2891,11826301
0400000US27,27,Minnesota,,2015,1240,Health,3085,16566837,2170,1541723,62518,3438,5255,18108560
0400000US27,27,Minnesota,,2015,1260,Hospitals,3293,17056700,1303,4352987,229951,4592,4596,21409687
0400000US27,27,Minnesota,,2015,1280,Social Insurance Administration,1006,4764684,80,199042,8178,1053,1086,4963726
0400000US27,27,Minnesota,,2015,1300,Solid Waste Management,0,0,0,0,0,0,0,0
0400000US27,27,Minnesota,,2015,1320,Sewerage,607,3927682,13,38591,1134,613,620,3966273
0400000US27,27,Minnesota,,2015,1340,Parks and Recreation,524,2667240,148,194513,10620,585,672,2861753
0400000US27,27,Minnesota,,2015,1360,Housing and Community Development,0,0,0,0,0,0,0,0
0400000US27,27,Minnesota,,2015,1380,Natural Resources,2753,14650296,734,1360963,79946,3204,3487,16011259
0400000US27,27,Minnesota,,2015,1400,Water Supply,0,0,0,0,0,0,0,0
0400000US27,27,Minnesota,,2015,1420,Electric Power,0,0,0,0,0,0,0,0
0400000US27,27,Minnesota,,2015,1440,Gas Supply,0,0,0,0,0,0,0,0
0400000US27,27,Minnesota,,2015,1460,Transit,2636,13993670,428,1055814,44642,2888,3064,15049484
0400000US27,27,Minnesota,,2015,1480,Education Total ,31256,193278304,27429,35157824,1616660,40390,58685,228436128
0400000US27,27,Minnesota,,2015,1481,Education - Elementary and Secondary Total ,0,0,0,0,0,0,0,0
0400000US27,27,Minnesota,,2015,14811,Education - Elementary and Secondary Instructional             ,0,0,0,0,0,0,0,0
0400000US27,27,Minnesota,,2015,14812,Education - Elementary and Secondary Other ,0,0,0,0,0,0,0,0
0400000US27,27,Minnesota,,2015,1482,Education - Higher Education Total ,27932,175156665,26211,32888619,1511914,36474,54143,208045284
0400000US27,27,Minnesota,,2015,14821,Education - Higher Education Instructional,11519,79307757,10639,17651129,631781,15088,22158,96958886
0400000US27,27,Minnesota,,2015,14822,Education - Higher Education Other ,16413,95848908,15572,15237490,880133,21386,31985,111086398
0400000US27,27,Minnesota,,2015,1483,Education - Other,3324,18121639,1218,2269205,104746,3916,4542,20390844
0400000US27,27,Minnesota,,2015,1500,Libraries                          ,0,0,0,0,0,0,0,0
0400000US27,27,Minnesota,,2015,1560,State liquor stores,0,0,0,0,0,0,0,0
0400000US27,27,Minnesota,,2015,1580,All other and unallocable,3163,16910846,178,412718,18090,3266,3341,17323564
0400000US28,28,Mississippi,,2015,1000,Total - All Government Employment Functions,51936,196743496,13482,13194814,834089,56711,65418,209938310
0400000US28,28,Mississippi,,2015,1020,Financial Administration,1577,6003654,46,120151,5118,1606,1623,6123805
0400000US28,28,Mississippi,,2015,1040,Other Government Administration,465,2094098,21,64709,3196,483,486,2158807
0400000US28,28,Mississippi,,2015,1060,Judicial and Legal,453,2425366,0,0,0,453,453,2425366
0400000US28,28,Mississippi,,2015,1100,Police Protection Total,1227,4437053,1,1913,76,1227,1228,4438966
0400000US28,28,Mississippi,,2015,1101,Police Protection - Persons with Power of Arrest       ,646,2568398,0,0,0,646,646,2568398
0400000US28,28,Mississippi,,2015,1102,Police Protection - Other ,581,1868655,1,1913,76,581,582,1870568
0400000US28,28,Mississippi,,2015,1120,Fire Protection Total ,0,0,0,0,0,0,0,0
0400000US28,28,Mississippi,,2015,1121,Fire Protection - Firefighters,0,0,0,0,0,0,0,0
0400000US28,28,Mississippi,,2015,1122,Fire Protection - Other ,0,0,0,0,0,0,0,0
0400000US28,28,Mississippi,,2015,1140,Corrections,2974,7302010,14,26767,1964,2985,2988,7328777
0400000US28,28,Mississippi,,2015,1160,Highways,3169,9712309,7,13719,853,3174,3176,9726028
0400000US28,28,Mississippi,,2015,1180,Air Transportation,0,0,0,0,0,0,0,0
0400000US28,28,Mississippi,,2015,1200,Water Transport and Terminals       ,40,229723,1,2038,88,40,41,231761
0400000US28,28,Mississippi,,2015,1220,Public Welfare,4452,12050813,56,101006,920,4457,4508,12151819
0400000US28,28,Mississippi,,2015,1240,Health,3236,10970290,87,162568,6847,3274,3323,11132858
0400000US28,28,Mississippi,,2015,1260,Hospitals,10481,35749166,1067,1404746,67654,10863,11548,37153912
0400000US28,28,Mississippi,,2015,1280,Social Insurance Administration,600,2038583,168,405550,29430,766,768,2444133
0400000US28,28,Mississippi,,2015,1300,Solid Waste Management,0,0,0,0,0,0,0,0
0400000US28,28,Mississippi,,2015,1320,Sewerage,0,0,0,0,0,0,0,0
0400000US28,28,Mississippi,,2015,1340,Parks and Recreation,231,613477,65,59722,6287,267,296,673199
0400000US28,28,Mississippi,,2015,1360,Housing and Community Development,0,0,0,0,0,0,0,0
0400000US28,28,Mississippi,,2015,1380,Natural Resources,2848,9484697,745,666775,41893,3087,3593,10151472
0400000US28,28,Mississippi,,2015,1400,Water Supply,139,315232,4,3049,251,140,143,318281
0400000US28,28,Mississippi,,2015,1420,Electric Power,0,0,0,0,0,0,0,0
0400000US28,28,Mississippi,,2015,1440,Gas Supply,0,0,0,0,0,0,0,0
0400000US28,28,Mississippi,,2015,1460,Transit,0,0,0,0,0,0,0,0
0400000US28,28,Mississippi,,2015,1480,Education Total ,17386,83757205,11176,10126733,667645,21221,28562,93883938
0400000US28,28,Mississippi,,2015,1481,Education - Elementary and Secondary Total ,0,0,0,0,0,0,0,0
0400000US28,28,Mississippi,,2015,14811,Education - Elementary and Secondary Instructional             ,0,0,0,0,0,0,0,0
0400000US28,28,Mississippi,,2015,14812,Education - Elementary and Secondary Other ,0,0,0,0,0,0,0,0
0400000US28,28,Mississippi,,2015,1482,Education - Higher Education Total ,16006,79163762,11156,10093431,667109,19838,27162,89257193
0400000US28,28,Mississippi,,2015,14821,Education - Higher Education Instructional,6057,32106502,1714,2337705,102869,6641,7771,34444207
0400000US28,28,Mississippi,,2015,14822,Education - Higher Education Other ,9949,47057260,9442,7755726,564240,13197,19391,54812986
0400000US28,28,Mississippi,,2015,1483,Education - Other,1380,4593443,20,33302,536,1383,1400,4626745
0400000US28,28,Mississippi,,2015,1500,Libraries                          ,0,0,0,0,0,0,0,0
0400000US28,28,Mississippi,,2015,1560,State liquor stores,115,263600,0,0,0,115,115,263600
0400000US28,28,Mississippi,,2015,1580,All other and unallocable,2543,9296220,24,35368,1867,2553,2567,9331588
0400000US29,29,Missouri,,2015,1000,Total - All Government Employment Functions,77626,297663062,28982,26115568,1697791,87578,106608,323778630
0400000US29,29,Missouri,,2015,1020,Financial Administration,2770,10468356,153,186176,14318,2851,2923,10654532
0400000US29,29,Missouri,,2015,1040,Other Government Administration,718,2588652,310,759652,35958,920,1028,3348304
0400000US29,29,Missouri,,2015,1060,Judicial and Legal,3993,16307258,347,443668,33850,4184,4340,16750926
0400000US29,29,Missouri,,2015,1100,Police Protection Total,2415,10420012,128,131474,10240,2473,2543,10551486
0400000US29,29,Missouri,,2015,1101,Police Protection - Persons with Power of Arrest       ,1295,6700680,0,0,0,1295,1295,6700680
0400000US29,29,Missouri,,2015,1102,Police Protection - Other ,1120,3719332,128,131474,10240,1178,1248,3850806
0400000US29,29,Missouri,,2015,1120,Fire Protection Total ,0,0,0,0,0,0,0,0
0400000US29,29,Missouri,,2015,1121,Fire Protection - Firefighters,0,0,0,0,0,0,0,0
0400000US29,29,Missouri,,2015,1122,Fire Protection - Other ,0,0,0,0,0,0,0,0
0400000US29,29,Missouri,,2015,1140,Corrections,12159,32832484,128,116038,8462,12207,12287,32948522
0400000US29,29,Missouri,,2015,1160,Highways,5520,18024204,0,0,0,5520,5520,18024204
0400000US29,29,Missouri,,2015,1180,Air Transportation,0,0,0,0,0,0,0,0
0400000US29,29,Missouri,,2015,1200,Water Transport and Terminals       ,0,0,0,0,0,0,0,0
0400000US29,29,Missouri,,2015,1220,Public Welfare,6816,19195670,203,239616,13180,6891,7019,19435286
0400000US29,29,Missouri,,2015,1240,Health,2780,9789294,157,243280,10565,2841,2937,10032574
0400000US29,29,Missouri,,2015,1260,Hospitals,9555,32192810,1181,1654206,89458,10076,10736,33847016
0400000US29,29,Missouri,,2015,1280,Social Insurance Administration,496,1549752,48,26530,1556,505,544,1576282
0400000US29,29,Missouri,,2015,1300,Solid Waste Management,0,0,0,0,0,0,0,0
0400000US29,29,Missouri,,2015,1320,Sewerage,0,0,0,0,0,0,0,0
0400000US29,29,Missouri,,2015,1340,Parks and Recreation,499,1528248,216,57251,6337,535,715,1585499
0400000US29,29,Missouri,,2015,1360,Housing and Community Development,0,0,0,0,0,0,0,0
0400000US29,29,Missouri,,2015,1380,Natural Resources,1888,6961686,482,459964,44498,2140,2370,7421650
0400000US29,29,Missouri,,2015,1400,Water Supply,0,0,0,0,0,0,0,0
0400000US29,29,Missouri,,2015,1420,Electric Power,0,0,0,0,0,0,0,0
0400000US29,29,Missouri,,2015,1440,Gas Supply,0,0,0,0,0,0,0,0
0400000US29,29,Missouri,,2015,1460,Transit,0,0,0,0,0,0,0,0
0400000US29,29,Missouri,,2015,1480,Education Total ,24160,122188630,25399,21523831,1412697,32486,49559,143712461
0400000US29,29,Missouri,,2015,1481,Education - Elementary and Secondary Total ,0,0,0,0,0,0,0,0
0400000US29,29,Missouri,,2015,14811,Education - Elementary and Secondary Instructional             ,0,0,0,0,0,0,0,0
0400000US29,29,Missouri,,2015,14812,Education - Elementary and Secondary Other ,0,0,0,0,0,0,0,0
0400000US29,29,Missouri,,2015,1482,Education - Higher Education Total ,23133,118487710,24428,19851907,1309025,30874,47561,138339617
0400000US29,29,Missouri,,2015,14821,Education - Higher Education Instructional,8580,59939986,8544,10796820,555761,11888,17124,70736806
0400000US29,29,Missouri,,2015,14822,Education - Higher Education Other ,14553,58547724,15884,9055087,753264,18986,30437,67602811
0400000US29,29,Missouri,,2015,1483,Education - Other,1027,3700920,971,1671924,103672,1612,1998,5372844
0400000US29,29,Missouri,,2015,1500,Libraries                          ,0,0,0,0,0,0,0,0
0400000US29,29,Missouri,,2015,1560,State liquor stores,0,0,0,0,0,0,0,0
0400000US29,29,Missouri,,2015,1580,All other and unallocable,3857,13616006,230,273882,16672,3949,4087,13889888
0400000US30,30,Montana,,2015,1000,Total - All Government Employment Functions,17414,79095030,9758,10802387,612439,20877,27172,89897417
0400000US30,30,Montana,,2015,1020,Financial Administration,987,4123352,78,161555,8864,1038,1065,4284907
0400000US30,30,Montana,,2015,1040,Other Government Administration,584,2525785,112,217157,12896,658,696,2742942
0400000US30,30,Montana,,2015,1060,Judicial and Legal,695,3430308,75,170536,7641,738,770,3600844
0400000US30,30,Montana,,2015,1100,Police Protection Total,491,2398318,23,41623,2082,503,514,2439941
0400000US30,30,Montana,,2015,1101,Police Protection - Persons with Power of Arrest       ,231,1214826,3,10308,350,233,234,1225134
0400000US30,30,Montana,,2015,1102,Police Protection - Other ,260,1183492,20,31315,1732,270,280,1214807
0400000US30,30,Montana,,2015,1120,Fire Protection Total ,0,0,0,0,0,0,0,0
0400000US30,30,Montana,,2015,1121,Fire Protection - Firefighters,0,0,0,0,0,0,0,0
0400000US30,30,Montana,,2015,1122,Fire Protection - Other ,0,0,0,0,0,0,0,0
0400000US30,30,Montana,,2015,1140,Corrections,1192,4725811,90,210021,10243,1250,1282,4935832
0400000US30,30,Montana,,2015,1160,Highways,1994,9645925,183,355366,16678,2088,2177,10001291
0400000US30,30,Montana,,2015,1180,Air Transportation,0,0,0,0,0,0,0,0
0400000US30,30,Montana,,2015,1200,Water Transport and Terminals       ,0,0,0,0,0,0,0,0
0400000US30,30,Montana,,2015,1220,Public Welfare,1673,6442179,159,313636,18412,1777,1832,6755815
0400000US30,30,Montana,,2015,1240,Health,852,3676908,102,167303,8951,902,954,3844211
0400000US30,30,Montana,,2015,1260,Hospitals,582,2208008,220,311889,18177,685,802,2519897
0400000US30,30,Montana,,2015,1280,Social Insurance Administration,679,3078017,41,71336,4033,702,720,3149353
0400000US30,30,Montana,,2015,1300,Solid Waste Management,0,0,0,0,0,0,0,0
0400000US30,30,Montana,,2015,1320,Sewerage,0,0,0,0,0,0,0,0
0400000US30,30,Montana,,2015,1340,Parks and Recreation,65,277344,14,20035,1083,71,79,297379
0400000US30,30,Montana,,2015,1360,Housing and Community Development,0,0,0,0,0,0,0,0
0400000US30,30,Montana,,2015,1380,Natural Resources,1314,5898271,401,706160,38358,1530,1715,6604431
0400000US30,30,Montana,,2015,1400,Water Supply,0,0,0,0,0,0,0,0
0400000US30,30,Montana,,2015,1420,Electric Power,0,0,0,0,0,0,0,0
0400000US30,30,Montana,,2015,1440,Gas Supply,0,0,0,0,0,0,0,0
0400000US30,30,Montana,,2015,1460,Transit,0,0,0,0,0,0,0,0
0400000US30,30,Montana,,2015,1480,Education Total ,5142,25166850,8166,7842847,455722,7719,13308,33009697
0400000US30,30,Montana,,2015,1481,Education - Elementary and Secondary Total ,0,0,0,0,0,0,0,0
0400000US30,30,Montana,,2015,14811,Education - Elementary and Secondary Instructional             ,0,0,0,0,0,0,0,0
0400000US30,30,Montana,,2015,14812,Education - Elementary and Secondary Other ,0,0,0,0,0,0,0,0
0400000US30,30,Montana,,2015,1482,Education - Higher Education Total ,4828,23699722,8034,7614327,443676,7336,12862,31314049
0400000US30,30,Montana,,2015,14821,Education - Higher Education Instructional,1383,9261787,1428,2427769,102958,1965,2811,11689556
0400000US30,30,Montana,,2015,14822,Education - Higher Education Other ,3445,14437935,6606,5186558,340718,5371,10051,19624493
0400000US30,30,Montana,,2015,1483,Education - Other,314,1467128,132,228520,12046,383,446,1695648
0400000US30,30,Montana,,2015,1500,Libraries                          ,0,0,0,0,0,0,0,0
0400000US30,30,Montana,,2015,1560,State liquor stores,30,119828,2,2553,135,31,32,122381
0400000US30,30,Montana,,2015,1580,All other and unallocable,1134,5378126,92,210370,9164,1185,1226,5588496
0400000US31,31,Nebraska,,2015,1000,Total - All Government Employment Functions,26763,113686468,10234,11921586,948281,32122,36997,125608054
0400000US31,31,Nebraska,,2015,1020,Financial Administration,796,3125470,14,18301,887,801,810,3143771
0400000US31,31,Nebraska,,2015,1040,Other Government Administration,276,1080542,95,95663,6914,315,371,1176205
0400000US31,31,Nebraska,,2015,1060,Judicial and Legal,772,4083816,11,6350,666,776,783,4090166
0400000US31,31,Nebraska,,2015,1100,Police Protection Total,748,3635545,14,27966,2048,759,762,3663511
0400000US31,31,Nebraska,,2015,1101,Police Protection - Persons with Power of Arrest       ,436,2530044,0,0,0,436,436,2530044
0400000US31,31,Nebraska,,2015,1102,Police Protection - Other ,312,1105501,14,27966,2048,323,326,1133467
0400000US31,31,Nebraska,,2015,1120,Fire Protection Total ,0,0,0,0,0,0,0,0
0400000US31,31,Nebraska,,2015,1121,Fire Protection - Firefighters,0,0,0,0,0,0,0,0
0400000US31,31,Nebraska,,2015,1122,Fire Protection - Other ,0,0,0,0,0,0,0,0
0400000US31,31,Nebraska,,2015,1140,Corrections,2859,10552819,68,95001,5549,2890,2927,10647820
0400000US31,31,Nebraska,,2015,1160,Highways,2057,7930870,6,20374,748,2061,2063,7951244
0400000US31,31,Nebraska,,2015,1180,Air Transportation,19,90013,0,0,0,19,19,90013
0400000US31,31,Nebraska,,2015,1200,Water Transport and Terminals       ,0,0,0,0,0,0,0,0
0400000US31,31,Nebraska,,2015,1220,Public Welfare,2426,7778446,238,366721,23056,2556,2664,8145167
0400000US31,31,Nebraska,,2015,1240,Health,624,2295552,15,22943,1576,633,639,2318495
0400000US31,31,Nebraska,,2015,1260,Hospitals,3097,12397169,734,1877635,115087,3747,3831,14274804
0400000US31,31,Nebraska,,2015,1280,Social Insurance Administration,232,914372,5,8459,535,235,237,922831
0400000US31,31,Nebraska,,2015,1300,Solid Waste Management,0,0,0,0,0,0,0,0
0400000US31,31,Nebraska,,2015,1320,Sewerage,0,0,0,0,0,0,0,0
0400000US31,31,Nebraska,,2015,1340,Parks and Recreation,205,723347,162,136226,12739,277,367,859573
0400000US31,31,Nebraska,,2015,1360,Housing and Community Development,0,0,0,0,0,0,0,0
0400000US31,31,Nebraska,,2015,1380,Natural Resources,1511,5850859,777,1634771,111136,2140,2288,7485630
0400000US31,31,Nebraska,,2015,1400,Water Supply,0,0,0,0,0,0,0,0
0400000US31,31,Nebraska,,2015,1420,Electric Power,0,0,0,0,0,0,0,0
0400000US31,31,Nebraska,,2015,1440,Gas Supply,0,0,0,0,0,0,0,0
0400000US31,31,Nebraska,,2015,1460,Transit,0,0,0,0,0,0,0,0
0400000US31,31,Nebraska,,2015,1480,Education Total ,9319,45848982,7986,7508831,661532,13058,17305,53357813
0400000US31,31,Nebraska,,2015,1481,Education - Elementary and Secondary Total ,0,0,0,0,0,0,0,0
0400000US31,31,Nebraska,,2015,14811,Education - Elementary and Secondary Instructional             ,0,0,0,0,0,0,0,0
0400000US31,31,Nebraska,,2015,14812,Education - Elementary and Secondary Other ,0,0,0,0,0,0,0,0
0400000US31,31,Nebraska,,2015,1482,Education - Higher Education Total ,8783,43470535,7961,7463562,659216,12508,16744,50934097
0400000US31,31,Nebraska,,2015,14821,Education - Higher Education Instructional,2774,19863829,1105,2134111,97913,3327,3879,21997940
0400000US31,31,Nebraska,,2015,14822,Education - Higher Education Other ,6009,23606706,6856,5329451,561303,9181,12865,28936157
0400000US31,31,Nebraska,,2015,1483,Education - Other,536,2378447,25,45269,2316,550,561,2423716
0400000US31,31,Nebraska,,2015,1500,Libraries                          ,0,0,0,0,0,0,0,0
0400000US31,31,Nebraska,,2015,1560,State liquor stores,0,0,0,0,0,0,0,0
0400000US31,31,Nebraska,,2015,1580,All other and unallocable,1822,7378666,109,102345,5808,1855,1931,7481011
0400000US32,32,Nevada,,2015,1000,Total - All Government Employment Functions,25246,121623459,9859,11233903,554705,28377,35105,132857362
0400000US32,32,Nevada,,2015,1020,Financial Administration,1402,5487253,11,13015,263,1403,1413,5500268
0400000US32,32,Nevada,,2015,1040,Other Government Administration,1279,6452184,11,26459,883,1284,1290,6478643
0400000US32,32,Nevada,,2015,1060,Judicial and Legal,689,4695537,13,26997,446,692,702,4722534
0400000US32,32,Nevada,,2015,1100,Police Protection Total,867,5231711,10,29290,899,872,877,5261001
0400000US32,32,Nevada,,2015,1101,Police Protection - Persons with Power of Arrest       ,488,3587770,7,21766,611,491,495,3609536
0400000US32,32,Nevada,,2015,1102,Police Protection - Other ,379,1643941,3,7524,288,381,382,1651465
0400000US32,32,Nevada,,2015,1120,Fire Protection Total ,0,0,0,0,0,0,0,0
0400000US32,32,Nevada,,2015,1121,Fire Protection - Firefighters,0,0,0,0,0,0,0,0
0400000US32,32,Nevada,,2015,1122,Fire Protection - Other ,0,0,0,0,0,0,0,0
0400000US32,32,Nevada,,2015,1140,Corrections,3582,15529138,40,146311,1665,3591,3622,15675449
0400000US32,32,Nevada,,2015,1160,Highways,1719,7542694,1,126,7,1719,1720,7542820
0400000US32,32,Nevada,,2015,1180,Air Transportation,0,0,0,0,0,0,0,0
0400000US32,32,Nevada,,2015,1200,Water Transport and Terminals       ,0,0,0,0,0,0,0,0
0400000US32,32,Nevada,,2015,1220,Public Welfare,2297,8239438,8,17128,593,2301,2305,8256566
0400000US32,32,Nevada,,2015,1240,Health,1406,6168733,27,70601,1721,1416,1433,6239334
0400000US32,32,Nevada,,2015,1260,Hospitals,1338,5988193,35,98441,2015,1349,1373,6086634
0400000US32,32,Nevada,,2015,1280,Social Insurance Administration,518,1837359,0,0,0,518,518,1837359
0400000US32,32,Nevada,,2015,1300,Solid Waste Management,0,0,0,0,0,0,0,0
0400000US32,32,Nevada,,2015,1320,Sewerage,0,0,0,0,0,0,0,0
0400000US32,32,Nevada,,2015,1340,Parks and Recreation,166,651352,7,11122,372,168,173,662474
0400000US32,32,Nevada,,2015,1360,Housing and Community Development,0,0,0,0,0,0,0,0
0400000US32,32,Nevada,,2015,1380,Natural Resources,829,3878464,112,149114,7880,874,941,4027578
0400000US32,32,Nevada,,2015,1400,Water Supply,18,106091,0,0,0,18,18,106091
0400000US32,32,Nevada,,2015,1420,Electric Power,18,106091,0,0,0,18,18,106091
0400000US32,32,Nevada,,2015,1440,Gas Supply,0,0,0,0,0,0,0,0
0400000US32,32,Nevada,,2015,1460,Transit,0,0,0,0,0,0,0,0
0400000US32,32,Nevada,,2015,1480,Education Total ,7011,39659696,9524,10554233,533941,10028,16535,50213929
0400000US32,32,Nevada,,2015,1481,Education - Elementary and Secondary Total ,0,0,0,0,0,0,0,0
0400000US32,32,Nevada,,2015,14811,Education - Elementary and Secondary Instructional             ,0,0,0,0,0,0,0,0
0400000US32,32,Nevada,,2015,14812,Education - Elementary and Secondary Other ,0,0,0,0,0,0,0,0
0400000US32,32,Nevada,,2015,1482,Education - Higher Education Total ,6863,38935706,9522,10550367,533848,9879,16385,49486073
0400000US32,32,Nevada,,2015,14821,Education - Higher Education Instructional,2072,17365987,4200,5806403,271310,3605,6272,23172390
0400000US32,32,Nevada,,2015,14822,Education - Higher Education Other ,4791,21569719,5322,4743964,262538,6274,10113,26313683
0400000US32,32,Nevada,,2015,1483,Education - Other,148,723990,2,3866,93,149,150,727856
0400000US32,32,Nevada,,2015,1500,Libraries                          ,0,0,0,0,0,0,0,0
0400000US32,32,Nevada,,2015,1560,State liquor stores,0,0,0,0,0,0,0,0
0400000US32,32,Nevada,,2015,1580,All other and unallocable,2107,10049525,60,91066,4020,2126,2167,10140591
0400000US33,33,New Hampshire,,2015,1000,Total - All Government Employment Functions,14881,77452852,11574,14158470,688172,19031,26455,91611322
0400000US33,33,New Hampshire,,2015,1020,Financial Administration,727,3607525,66,103017,6215,765,793,3710542
0400000US33,33,New Hampshire,,2015,1040,Other Government Administration,309,1490096,478,278701,6108,346,787,1768797
0400000US33,33,New Hampshire,,2015,1060,Judicial and Legal,665,3434480,248,537368,17597,772,913,3971848
0400000US33,33,New Hampshire,,2015,1100,Police Protection Total,496,2827206,45,70022,3786,519,541,2897228
0400000US33,33,New Hampshire,,2015,1101,Police Protection - Persons with Power of Arrest       ,331,2120404,0,0,0,331,331,2120404
0400000US33,33,New Hampshire,,2015,1102,Police Protection - Other ,165,706802,45,70022,3786,188,210,776824
0400000US33,33,New Hampshire,,2015,1120,Fire Protection Total ,0,0,0,0,0,0,0,0
0400000US33,33,New Hampshire,,2015,1121,Fire Protection - Firefighters,0,0,0,0,0,0,0,0
0400000US33,33,New Hampshire,,2015,1122,Fire Protection - Other ,0,0,0,0,0,0,0,0
0400000US33,33,New Hampshire,,2015,1140,Corrections,1016,5399343,68,147533,9041,1070,1084,5546876
0400000US33,33,New Hampshire,,2015,1160,Highways,1497,6614946,173,268779,16778,1598,1670,6883725
0400000US33,33,New Hampshire,,2015,1180,Air Transportation,29,174415,19,34020,2177,41,48,208435
0400000US33,33,New Hampshire,,2015,1200,Water Transport and Terminals       ,6,25980,3,2600,171,7,9,28580
0400000US33,33,New Hampshire,,2015,1220,Public Welfare,1877,8027521,134,272526,15001,1968,2011,8300047
0400000US33,33,New Hampshire,,2015,1240,Health,743,3732810,49,99395,4777,772,792,3832205
0400000US33,33,New Hampshire,,2015,1260,Hospitals,535,2289837,84,120092,8215,584,619,2409929
0400000US33,33,New Hampshire,,2015,1280,Social Insurance Administration,265,1076539,51,85888,4798,294,316,1162427
0400000US33,33,New Hampshire,,2015,1300,Solid Waste Management,0,0,0,0,0,0,0,0
0400000US33,33,New Hampshire,,2015,1320,Sewerage,0,0,0,0,0,0,0,0
0400000US33,33,New Hampshire,,2015,1340,Parks and Recreation,151,623743,335,310228,24334,298,486,933971
0400000US33,33,New Hampshire,,2015,1360,Housing and Community Development,0,0,0,0,0,0,0,0
0400000US33,33,New Hampshire,,2015,1380,Natural Resources,332,1674855,73,82131,4748,360,405,1756986
0400000US33,33,New Hampshire,,2015,1400,Water Supply,22,105874,9,14769,682,26,31,120643
0400000US33,33,New Hampshire,,2015,1420,Electric Power,0,0,0,0,0,0,0,0
0400000US33,33,New Hampshire,,2015,1440,Gas Supply,0,0,0,0,0,0,0,0
0400000US33,33,New Hampshire,,2015,1460,Transit,0,0,0,0,0,0,0,0
0400000US33,33,New Hampshire,,2015,1480,Education Total ,4652,29048459,8598,10497359,479681,7546,13250,39545818
0400000US33,33,New Hampshire,,2015,1481,Education - Elementary and Secondary Total ,0,0,0,0,0,0,0,0
0400000US33,33,New Hampshire,,2015,14811,Education - Elementary and Secondary Instructional             ,0,0,0,0,0,0,0,0
0400000US33,33,New Hampshire,,2015,14812,Education - Elementary and Secondary Other ,0,0,0,0,0,0,0,0
0400000US33,33,New Hampshire,,2015,1482,Education - Higher Education Total ,4365,27715622,8569,10431697,476559,7240,12934,38147319
0400000US33,33,New Hampshire,,2015,14821,Education - Higher Education Instructional,1526,13145756,2247,5040715,138249,2361,3773,18186471
0400000US33,33,New Hampshire,,2015,14822,Education - Higher Education Other ,2839,14569866,6322,5390982,338310,4879,9161,19960848
0400000US33,33,New Hampshire,,2015,1483,Education - Other,287,1332837,29,65662,3122,306,316,1398499
0400000US33,33,New Hampshire,,2015,1500,Libraries                          ,0,0,0,0,0,0,0,0
0400000US33,33,New Hampshire,,2015,1560,State liquor stores,304,1236353,723,732118,57410,650,1027,1968471
0400000US33,33,New Hampshire,,2015,1580,All other and unallocable,1255,6062870,418,501924,26653,1415,1673,6564794
0400000US34,34,New Jersey,,2015,1000,Total - All Government Employment Functions,127875,798385470,29590,48178796,2102102,140992,157465,846564266
0400000US34,34,New Jersey,,2015,1020,Financial Administration,5114,27566467,305,610731,31503,5317,5419,28177198
0400000US34,34,New Jersey,,2015,1040,Other Government Administration,1103,6882347,36,73656,3196,1124,1139,6956003
0400000US34,34,New Jersey,,2015,1060,Judicial and Legal,12732,79899485,178,340970,14740,12827,12910,80240455
0400000US34,34,New Jersey,,2015,1100,Police Protection Total,4040,29207576,48,121788,3846,4065,4088,29329364
0400000US34,34,New Jersey,,2015,1101,Police Protection - Persons with Power of Arrest       ,2653,22818624,0,0,0,2653,2653,22818624
0400000US34,34,New Jersey,,2015,1102,Police Protection - Other ,1387,6388952,48,121788,3846,1412,1435,6510740
0400000US34,34,New Jersey,,2015,1120,Fire Protection Total ,0,0,0,0,0,0,0,0
0400000US34,34,New Jersey,,2015,1121,Fire Protection - Firefighters,0,0,0,0,0,0,0,0
0400000US34,34,New Jersey,,2015,1122,Fire Protection - Other ,0,0,0,0,0,0,0,0
0400000US34,34,New Jersey,,2015,1140,Corrections,8523,51708917,15,41826,1229,8531,8538,51750743
0400000US34,34,New Jersey,,2015,1160,Highways,5299,33696338,645,812316,71721,5728,5944,34508654
0400000US34,34,New Jersey,,2015,1180,Air Transportation,0,0,0,0,0,0,0,0
0400000US34,34,New Jersey,,2015,1200,Water Transport and Terminals       ,110,634641,5,9663,629,114,115,644304
0400000US34,34,New Jersey,,2015,1220,Public Welfare,8929,52142620,179,332185,14645,9023,9108,52474805
0400000US34,34,New Jersey,,2015,1240,Health,3775,22581381,754,2120342,32253,3972,4529,24701723
0400000US34,34,New Jersey,,2015,1260,Hospitals,12912,65338388,1923,4038982,176117,14042,14835,69377370
0400000US34,34,New Jersey,,2015,1280,Social Insurance Administration,1486,7724928,63,178677,6962,1531,1549,7903605
0400000US34,34,New Jersey,,2015,1300,Solid Waste Management,476,3432081,10,10750,678,480,486,3442831
0400000US34,34,New Jersey,,2015,1320,Sewerage,0,0,0,0,0,0,0,0
0400000US34,34,New Jersey,,2015,1340,Parks and Recreation,782,4464937,254,396444,17719,892,1036,4861381
0400000US34,34,New Jersey,,2015,1360,Housing and Community Development,0,0,0,0,0,0,0,0
0400000US34,34,New Jersey,,2015,1380,Natural Resources,1726,10667001,337,522539,23623,1871,2063,11189540
0400000US34,34,New Jersey,,2015,1400,Water Supply,106,584005,0,0,0,106,106,584005
0400000US34,34,New Jersey,,2015,1420,Electric Power,0,0,0,0,0,0,0,0
0400000US34,34,New Jersey,,2015,1440,Gas Supply,0,0,0,0,0,0,0,0
0400000US34,34,New Jersey,,2015,1460,Transit,10713,62154893,792,1280461,64477,11077,11505,63435354
0400000US34,34,New Jersey,,2015,1480,Education Total ,44415,303722881,23766,36970134,1623618,54560,68181,340693015
0400000US34,34,New Jersey,,2015,1481,Education - Elementary and Secondary Total ,14774,96928531,3554,6372666,333748,16896,18328,103301197
0400000US34,34,New Jersey,,2015,14811,Education - Elementary and Secondary Instructional             ,10619,78912378,875,1876027,71043,11072,11494,80788405
0400000US34,34,New Jersey,,2015,14812,Education - Elementary and Secondary Other ,4155,18016153,2679,4496639,262705,5824,6834,22512792
0400000US34,34,New Jersey,,2015,1482,Education - Higher Education Total ,27348,192323468,19794,29660929,1249777,35114,47142,221984397
0400000US34,34,New Jersey,,2015,14821,Education - Higher Education Instructional,7571,85390871,6480,13217604,281968,9344,14051,98608475
0400000US34,34,New Jersey,,2015,14822,Education - Higher Education Other ,19777,106932597,13314,16443325,967809,25770,33091,123375922
0400000US34,34,New Jersey,,2015,1483,Education - Other,2293,14470882,418,936539,40093,2550,2711,15407421
0400000US34,34,New Jersey,,2015,1500,Libraries                          ,0,0,0,0,0,0,0,0
0400000US34,34,New Jersey,,2015,1560,State liquor stores,0,0,0,0,0,0,0,0
0400000US34,34,New Jersey,,2015,1580,All other and unallocable,5634,35976584,280,317332,15146,5732,5914,36293916
0400000US35,35,New Mexico,,2015,1000,Total - All Government Employment Functions,40994,189060028,13828,17793733,863286,45909,54822,206853761
0400000US35,35,New Mexico,,2015,1020,Financial Administration,1047,4696609,4,11886,532,1051,1051,4708495
0400000US35,35,New Mexico,,2015,1040,Other Government Administration,203,1067926,3,9242,531,206,206,1077168
0400000US35,35,New Mexico,,2015,1060,Judicial and Legal,3196,14739342,76,143121,5471,3227,3272,14882463
0400000US35,35,New Mexico,,2015,1100,Police Protection Total,517,2349362,0,0,0,517,517,2349362
0400000US35,35,New Mexico,,2015,1101,Police Protection - Persons with Power of Arrest       ,517,2349362,0,0,0,517,517,2349362
0400000US35,35,New Mexico,,2015,1102,Police Protection - Other ,0,0,0,0,0,0,0,0
0400000US35,35,New Mexico,,2015,1120,Fire Protection Total ,0,0,0,0,0,0,0,0
0400000US35,35,New Mexico,,2015,1121,Fire Protection - Firefighters,0,0,0,0,0,0,0,0
0400000US35,35,New Mexico,,2015,1122,Fire Protection - Other ,0,0,0,0,0,0,0,0
0400000US35,35,New Mexico,,2015,1140,Corrections,3770,13560607,29,71617,3543,3790,3799,13632224
0400000US35,35,New Mexico,,2015,1160,Highways,2173,9032977,0,0,0,2173,2173,9032977
0400000US35,35,New Mexico,,2015,1180,Air Transportation,5,27134,0,0,0,5,5,27134
0400000US35,35,New Mexico,,2015,1200,Water Transport and Terminals       ,0,0,0,0,0,0,0,0
0400000US35,35,New Mexico,,2015,1220,Public Welfare,1751,6341624,6,15863,1063,1757,1757,6357487
0400000US35,35,New Mexico,,2015,1240,Health,2397,10055528,12,15358,859,2402,2409,10070886
0400000US35,35,New Mexico,,2015,1260,Hospitals,7039,31190276,790,2183534,80412,7524,7829,33373810
0400000US35,35,New Mexico,,2015,1280,Social Insurance Administration,345,1115081,0,0,0,345,345,1115081
0400000US35,35,New Mexico,,2015,1300,Solid Waste Management,0,0,0,0,0,0,0,0
0400000US35,35,New Mexico,,2015,1320,Sewerage,0,0,0,0,0,0,0,0
0400000US35,35,New Mexico,,2015,1340,Parks and Recreation,630,2259814,23,39263,2811,646,653,2299077
0400000US35,35,New Mexico,,2015,1360,Housing and Community Development,0,0,0,0,0,0,0,0
0400000US35,35,New Mexico,,2015,1380,Natural Resources,976,4358478,40,52967,3191,995,1016,4411445
0400000US35,35,New Mexico,,2015,1400,Water Supply,0,0,0,0,0,0,0,0
0400000US35,35,New Mexico,,2015,1420,Electric Power,0,0,0,0,0,0,0,0
0400000US35,35,New Mexico,,2015,1440,Gas Supply,0,0,0,0,0,0,0,0
0400000US35,35,New Mexico,,2015,1460,Transit,0,0,0,0,0,0,0,0
0400000US35,35,New Mexico,,2015,1480,Education Total ,14867,79679260,12826,15201136,762307,19177,27693,94880396
0400000US35,35,New Mexico,,2015,1481,Education - Elementary and Secondary Total ,0,0,0,0,0,0,0,0
0400000US35,35,New Mexico,,2015,14811,Education - Elementary and Secondary Instructional             ,0,0,0,0,0,0,0,0
0400000US35,35,New Mexico,,2015,14812,Education - Elementary and Secondary Other ,0,0,0,0,0,0,0,0
0400000US35,35,New Mexico,,2015,1482,Education - Higher Education Total ,13973,75837876,12769,15139052,758269,18258,26742,90976928
0400000US35,35,New Mexico,,2015,14821,Education - Higher Education Instructional,4009,35617658,3950,7240490,216120,5231,7959,42858148
0400000US35,35,New Mexico,,2015,14822,Education - Higher Education Other ,9964,40220218,8819,7898562,542149,13027,18783,48118780
0400000US35,35,New Mexico,,2015,1483,Education - Other,894,3841384,57,62084,4038,919,951,3903468
0400000US35,35,New Mexico,,2015,1500,Libraries                          ,0,0,0,0,0,0,0,0
0400000US35,35,New Mexico,,2015,1560,State liquor stores,0,0,0,0,0,0,0,0
0400000US35,35,New Mexico,,2015,1580,All other and unallocable,2078,8586010,19,49746,2566,2094,2097,8635756
0400000US36,36,New York,,2015,1000,Total - All Government Employment Functions,224302,1376462018,45009,76739492,2920610,241893,269311,1453201510
0400000US36,36,New York,,2015,1020,Financial Administration,16698,93801444,146,338839,11880,16766,16844,94140283
0400000US36,36,New York,,2015,1040,Other Government Administration,4420,17965861,37,71732,2770,4437,4457,18037593
0400000US36,36,New York,,2015,1060,Judicial and Legal,18142,135400122,441,1734723,55612,18458,18583,137134845
0400000US36,36,New York,,2015,1100,Police Protection Total,6128,53973751,97,156379,12464,6198,6225,54130130
0400000US36,36,New York,,2015,1101,Police Protection - Persons with Power of Arrest       ,4982,48737483,0,0,0,4982,4982,48737483
0400000US36,36,New York,,2015,1102,Police Protection - Other ,1146,5236268,97,156379,12464,1216,1243,5392647
0400000US36,36,New York,,2015,1120,Fire Protection Total ,0,0,0,0,0,0,0,0
0400000US36,36,New York,,2015,1121,Fire Protection - Firefighters,0,0,0,0,0,0,0,0
0400000US36,36,New York,,2015,1122,Fire Protection - Other ,0,0,0,0,0,0,0,0
0400000US36,36,New York,,2015,1140,Corrections,28285,174802254,256,906454,28037,28443,28541,175708708
0400000US36,36,New York,,2015,1160,Highways,10052,64265519,1136,1373914,91915,10573,11188,65639433
0400000US36,36,New York,,2015,1180,Air Transportation,191,757693,1,3100,78,191,192,760793
0400000US36,36,New York,,2015,1200,Water Transport and Terminals       ,531,3300094,27,40455,1813,541,558,3340549
0400000US36,36,New York,,2015,1220,Public Welfare,4197,21701592,412,1138051,53161,4496,4609,22839643
0400000US36,36,New York,,2015,1240,Health,7864,47595868,233,869890,25310,8008,8097,48465758
0400000US36,36,New York,,2015,1260,Hospitals,37695,212623455,4462,13785447,483584,40429,42157,226408902
0400000US36,36,New York,,2015,1280,Social Insurance Administration,7421,40127131,41,134185,5503,7452,7462,40261316
0400000US36,36,New York,,2015,1300,Solid Waste Management,0,0,0,0,0,0,0,0
0400000US36,36,New York,,2015,1320,Sewerage,0,0,0,0,0,0,0,0
0400000US36,36,New York,,2015,1340,Parks and Recreation,2694,10744416,7,18277,974,2700,2701,10762693
0400000US36,36,New York,,2015,1360,Housing and Community Development,0,0,0,0,0,0,0,0
0400000US36,36,New York,,2015,1380,Natural Resources,2914,16304818,56,70997,2671,2929,2970,16375815
0400000US36,36,New York,,2015,1400,Water Supply,0,0,0,0,0,0,0,0
0400000US36,36,New York,,2015,1420,Electric Power,1672,13882254,40,129359,3245,1691,1712,14011613
0400000US36,36,New York,,2015,1440,Gas Supply,0,0,0,0,0,0,0,0
0400000US36,36,New York,,2015,1460,Transit,15644,116719971,112,185670,9806,15700,15756,116905641
0400000US36,36,New York,,2015,1480,Education Total ,49800,292380652,37117,54678342,2102125,62750,86917,347058994
0400000US36,36,New York,,2015,1481,Education - Elementary and Secondary Total ,0,0,0,0,0,0,0,0
0400000US36,36,New York,,2015,14811,Education - Elementary and Secondary Instructional             ,0,0,0,0,0,0,0,0
0400000US36,36,New York,,2015,14812,Education - Elementary and Secondary Other ,0,0,0,0,0,0,0,0
0400000US36,36,New York,,2015,1482,Education - Higher Education Total ,45993,270918530,37000,54358813,2089195,58870,82993,325277343
0400000US36,36,New York,,2015,14821,Education - Higher Education Instructional,15572,120668933,17583,29783873,822742,20610,33155,150452806
0400000US36,36,New York,,2015,14822,Education - Higher Education Other ,30421,150249597,19417,24574940,1266453,38260,49838,174824537
0400000US36,36,New York,,2015,1483,Education - Other,3807,21462122,117,319529,12930,3880,3924,21781651
0400000US36,36,New York,,2015,1500,Libraries                          ,0,0,0,0,0,0,0,0
0400000US36,36,New York,,2015,1560,State liquor stores,0,0,0,0,0,0,0,0
0400000US36,36,New York,,2015,1580,All other and unallocable,9954,60115123,388,1103678,29662,10131,10342,61218801
0400000US37,37,North Carolina,,2015,1000,Total - All Government Employment Functions,123191,564370943,45347,56760362,3094018,140669,168538,621131305
0400000US37,37,North Carolina,,2015,1020,Financial Administration,3461,16343167,26,20788,187,3461,3487,16363955
0400000US37,37,North Carolina,,2015,1040,Other Government Administration,662,3434797,526,1148255,64746,1028,1188,4583052
0400000US37,37,North Carolina,,2015,1060,Judicial and Legal,6297,30425353,478,348627,3714,6318,6775,30773980
0400000US37,37,North Carolina,,2015,1100,Police Protection Total,3149,14876846,8,15703,211,3150,3157,14892549
0400000US37,37,North Carolina,,2015,1101,Police Protection - Persons with Power of Arrest       ,2467,12485072,7,15046,131,2468,2474,12500118
0400000US37,37,North Carolina,,2015,1102,Police Protection - Other ,682,2391774,1,657,80,682,683,2392431
0400000US37,37,North Carolina,,2015,1120,Fire Protection Total ,0,0,0,0,0,0,0,0
0400000US37,37,North Carolina,,2015,1121,Fire Protection - Firefighters,0,0,0,0,0,0,0,0
0400000US37,37,North Carolina,,2015,1122,Fire Protection - Other ,0,0,0,0,0,0,0,0
0400000US37,37,North Carolina,,2015,1140,Corrections,19027,63298627,10,24388,1180,19034,19037,63323015
0400000US37,37,North Carolina,,2015,1160,Highways,10015,38312214,29,47927,3310,10034,10044,38360141
0400000US37,37,North Carolina,,2015,1180,Air Transportation,0,0,0,0,0,0,0,0
0400000US37,37,North Carolina,,2015,1200,Water Transport and Terminals       ,215,1041108,1,1550,133,216,216,1042658
0400000US37,37,North Carolina,,2015,1220,Public Welfare,1099,4148129,32,44589,439,1101,1131,4192718
0400000US37,37,North Carolina,,2015,1240,Health,2252,9208188,156,336400,12954,2325,2408,9544588
0400000US37,37,North Carolina,,2015,1260,Hospitals,17914,74256043,1697,4301545,65259,18282,19611,78557588
0400000US37,37,North Carolina,,2015,1280,Social Insurance Administration,1253,5013236,16,24485,238,1254,1269,5037721
0400000US37,37,North Carolina,,2015,1300,Solid Waste Management,313,1514239,0,0,0,313,313,1514239
0400000US37,37,North Carolina,,2015,1320,Sewerage,0,0,0,0,0,0,0,0
0400000US37,37,North Carolina,,2015,1340,Parks and Recreation,1530,4882397,304,301986,32946,1717,1834,5184383
0400000US37,37,North Carolina,,2015,1360,Housing and Community Development,0,0,0,0,0,0,0,0
0400000US37,37,North Carolina,,2015,1380,Natural Resources,4278,16348305,228,295375,13961,4358,4506,16643680
0400000US37,37,North Carolina,,2015,1400,Water Supply,0,0,0,0,0,0,0,0
0400000US37,37,North Carolina,,2015,1420,Electric Power,0,0,0,0,0,0,0,0
0400000US37,37,North Carolina,,2015,1440,Gas Supply,0,0,0,0,0,0,0,0
0400000US37,37,North Carolina,,2015,1460,Transit,0,0,0,0,0,0,0,0
0400000US37,37,North Carolina,,2015,1480,Education Total ,47062,259939571,41683,49646099,2887077,63370,88745,309585670
0400000US37,37,North Carolina,,2015,1481,Education - Elementary and Secondary Total ,0,0,0,0,0,0,0,0
0400000US37,37,North Carolina,,2015,14811,Education - Elementary and Secondary Instructional             ,0,0,0,0,0,0,0,0
0400000US37,37,North Carolina,,2015,14812,Education - Elementary and Secondary Other ,0,0,0,0,0,0,0,0
0400000US37,37,North Carolina,,2015,1482,Education - Higher Education Total ,44011,245830350,41443,49508909,2885705,60312,85454,295339259
0400000US37,37,North Carolina,,2015,14821,Education - Higher Education Instructional,15290,118036340,14040,25589281,990230,20884,29330,143625621
0400000US37,37,North Carolina,,2015,14822,Education - Higher Education Other ,28721,127794010,27403,23919628,1895475,39428,56124,151713638
0400000US37,37,North Carolina,,2015,1483,Education - Other,3051,14109221,240,137190,1372,3058,3291,14246411
0400000US37,37,North Carolina,,2015,1500,Libraries                          ,0,0,0,0,0,0,0,0
0400000US37,37,North Carolina,,2015,1560,State liquor stores,0,0,0,0,0,0,0,0
0400000US37,37,North Carolina,,2015,1580,All other and unallocable,4664,21328723,153,202645,7663,4708,4817,21531368
0400000US38,38,North Dakota,,2015,1000,Total - All Government Employment Functions,16170,76858278,10144,11755033,561576,19339,26314,88613311
0400000US38,38,North Dakota,,2015,1020,Financial Administration,674,3127539,53,102094,3927,696,727,3229633
0400000US38,38,North Dakota,,2015,1040,Other Government Administration,212,1017569,248,1143629,33561,402,460,2161198
0400000US38,38,North Dakota,,2015,1060,Judicial and Legal,596,3305121,57,51875,2551,611,653,3356996
0400000US38,38,North Dakota,,2015,1100,Police Protection Total,193,1041355,5,9460,477,196,198,1050815
0400000US38,38,North Dakota,,2015,1101,Police Protection - Persons with Power of Arrest       ,151,882830,0,0,0,151,151,882830
0400000US38,38,North Dakota,,2015,1102,Police Protection - Other ,42,158525,5,9460,477,45,47,167985
0400000US38,38,North Dakota,,2015,1120,Fire Protection Total ,0,0,0,0,0,0,0,0
0400000US38,38,North Dakota,,2015,1121,Fire Protection - Firefighters,0,0,0,0,0,0,0,0
0400000US38,38,North Dakota,,2015,1122,Fire Protection - Other ,0,0,0,0,0,0,0,0
0400000US38,38,North Dakota,,2015,1140,Corrections,848,3451648,89,207270,6961,887,937,3658918
0400000US38,38,North Dakota,,2015,1160,Highways,1012,5577178,6,13115,568,1015,1018,5590293
0400000US38,38,North Dakota,,2015,1180,Air Transportation,0,0,0,0,0,0,0,0
0400000US38,38,North Dakota,,2015,1200,Water Transport and Terminals       ,0,0,0,0,0,0,0,0
0400000US38,38,North Dakota,,2015,1220,Public Welfare,431,1527650,158,310014,17350,528,589,1837664
0400000US38,38,North Dakota,,2015,1240,Health,1588,6304704,382,366896,25894,1734,1970,6671600
0400000US38,38,North Dakota,,2015,1260,Hospitals,877,2572464,146,206753,7751,921,1023,2779217
0400000US38,38,North Dakota,,2015,1280,Social Insurance Administration,305,1316308,75,111949,5400,335,380,1428257
0400000US38,38,North Dakota,,2015,1300,Solid Waste Management,0,0,0,0,0,0,0,0
0400000US38,38,North Dakota,,2015,1320,Sewerage,0,0,0,0,0,0,0,0
0400000US38,38,North Dakota,,2015,1340,Parks and Recreation,185,658076,12,20373,1234,192,197,678449
0400000US38,38,North Dakota,,2015,1360,Housing and Community Development,0,0,0,0,0,0,0,0
0400000US38,38,North Dakota,,2015,1380,Natural Resources,937,4123238,489,597936,30274,1109,1426,4721174
0400000US38,38,North Dakota,,2015,1400,Water Supply,0,0,0,0,0,0,0,0
0400000US38,38,North Dakota,,2015,1420,Electric Power,0,0,0,0,0,0,0,0
0400000US38,38,North Dakota,,2015,1440,Gas Supply,0,0,0,0,0,0,0,0
0400000US38,38,North Dakota,,2015,1460,Transit,0,0,0,0,0,0,0,0
0400000US38,38,North Dakota,,2015,1480,Education Total ,6816,35361070,8263,8445691,417282,9171,15079,43806761
0400000US38,38,North Dakota,,2015,1481,Education - Elementary and Secondary Total ,0,0,0,0,0,0,0,0
0400000US38,38,North Dakota,,2015,14811,Education - Elementary and Secondary Instructional             ,0,0,0,0,0,0,0,0
0400000US38,38,North Dakota,,2015,14812,Education - Elementary and Secondary Other ,0,0,0,0,0,0,0,0
0400000US38,38,North Dakota,,2015,1482,Education - Higher Education Total ,6496,34020036,8203,8348360,412540,8825,14699,42368396
0400000US38,38,North Dakota,,2015,14821,Education - Higher Education Instructional,2051,15134534,3019,5439062,188914,3118,5070,20573596
0400000US38,38,North Dakota,,2015,14822,Education - Higher Education Other ,4445,18885502,5184,2909298,223626,5707,9629,21794800
0400000US38,38,North Dakota,,2015,1483,Education - Other,320,1341034,60,97331,4742,346,380,1438365
0400000US38,38,North Dakota,,2015,1500,Libraries                          ,0,0,0,0,0,0,0,0
0400000US38,38,North Dakota,,2015,1560,State liquor stores,0,0,0,0,0,0,0,0
0400000US38,38,North Dakota,,2015,1580,All other and unallocable,1496,7474358,161,167978,8346,1542,1657,7642336
0400000US39,39,Ohio,,2015,1000,Total - All Government Employment Functions,108664,570735268,76046,87333966,5195636,138038,184710,658069234
0400000US39,39,Ohio,,2015,1020,Financial Administration,6281,34976055,312,661863,37298,6490,6593,35637918
0400000US39,39,Ohio,,2015,1040,Other Government Administration,829,4141170,156,109957,9154,881,985,4251127
0400000US39,39,Ohio,,2015,1060,Judicial and Legal,2860,17282622,471,1498193,46677,3124,3331,18780815
0400000US39,39,Ohio,,2015,1100,Police Protection Total,2559,13573140,11,28748,1639,2568,2570,13601888
0400000US39,39,Ohio,,2015,1101,Police Protection - Persons with Power of Arrest       ,1407,8551080,0,0,0,1407,1407,8551080
0400000US39,39,Ohio,,2015,1102,Police Protection - Other ,1152,5022060,11,28748,1639,1161,1163,5050808
0400000US39,39,Ohio,,2015,1120,Fire Protection Total ,0,0,0,0,0,0,0,0
0400000US39,39,Ohio,,2015,1121,Fire Protection - Firefighters,0,0,0,0,0,0,0,0
0400000US39,39,Ohio,,2015,1122,Fire Protection - Other ,0,0,0,0,0,0,0,0
0400000US39,39,Ohio,,2015,1140,Corrections,13013,58019963,16,55366,2467,13027,13029,58075329
0400000US39,39,Ohio,,2015,1160,Highways,5645,26542475,692,1401771,86363,6133,6337,27944246
0400000US39,39,Ohio,,2015,1180,Air Transportation,0,0,0,0,0,0,0,0
0400000US39,39,Ohio,,2015,1200,Water Transport and Terminals       ,0,0,0,0,0,0,0,0
0400000US39,39,Ohio,,2015,1220,Public Welfare,2519,14216874,356,718759,55977,2836,2875,14935633
0400000US39,39,Ohio,,2015,1240,Health,2716,15496648,115,305193,13828,2794,2831,15801841
0400000US39,39,Ohio,,2015,1260,Hospitals,11721,58471719,5610,12994979,568974,14935,17331,71466698
0400000US39,39,Ohio,,2015,1280,Social Insurance Administration,1635,7611397,56,74006,4408,1660,1691,7685403
0400000US39,39,Ohio,,2015,1300,Solid Waste Management,0,0,0,0,0,0,0,0
0400000US39,39,Ohio,,2015,1320,Sewerage,0,0,0,0,0,0,0,0
0400000US39,39,Ohio,,2015,1340,Parks and Recreation,380,1650376,256,377157,23817,515,636,2027533
0400000US39,39,Ohio,,2015,1360,Housing and Community Development,0,0,0,0,0,0,0,0
0400000US39,39,Ohio,,2015,1380,Natural Resources,2209,10054936,385,737384,47318,2476,2594,10792320
0400000US39,39,Ohio,,2015,1400,Water Supply,0,0,0,0,0,0,0,0
0400000US39,39,Ohio,,2015,1420,Electric Power,0,0,0,0,0,0,0,0
0400000US39,39,Ohio,,2015,1440,Gas Supply,0,0,0,0,0,0,0,0
0400000US39,39,Ohio,,2015,1460,Transit,0,0,0,0,0,0,0,0
0400000US39,39,Ohio,,2015,1480,Education Total ,52003,285828028,67301,67874604,4273437,76166,119304,353702632
0400000US39,39,Ohio,,2015,1481,Education - Elementary and Secondary Total ,0,0,0,0,0,0,0,0
0400000US39,39,Ohio,,2015,14811,Education - Elementary and Secondary Instructional             ,0,0,0,0,0,0,0,0
0400000US39,39,Ohio,,2015,14812,Education - Elementary and Secondary Other ,0,0,0,0,0,0,0,0
0400000US39,39,Ohio,,2015,1482,Education - Higher Education Total ,50026,275710916,67178,67635994,4262917,74129,117204,343346910
0400000US39,39,Ohio,,2015,14821,Education - Higher Education Instructional,16457,124680893,19259,29419641,1210384,23306,35716,154100534
0400000US39,39,Ohio,,2015,14822,Education - Higher Education Other ,33569,151030023,47919,38216353,3052533,50823,81488,189246376
0400000US39,39,Ohio,,2015,1483,Education - Other,1977,10117112,123,238610,10520,2037,2100,10355722
0400000US39,39,Ohio,,2015,1500,Libraries                          ,0,0,0,0,0,0,0,0
0400000US39,39,Ohio,,2015,1560,State liquor stores,0,0,0,0,0,0,0,0
0400000US39,39,Ohio,,2015,1580,All other and unallocable,4294,22869865,309,495986,24279,4433,4603,23365851
0400000US40,40,Oklahoma,,2015,1000,Total - All Government Employment Functions,60621,253807756,26224,23616303,1442798,68785,86845,277424059
0400000US40,40,Oklahoma,,2015,1020,Financial Administration,2797,11683116,83,93130,5154,2825,2880,11776246
0400000US40,40,Oklahoma,,2015,1040,Other Government Administration,439,1741701,98,167251,10700,499,537,1908952
0400000US40,40,Oklahoma,,2015,1060,Judicial and Legal,2829,12877260,109,149829,8275,2875,2938,13027089
0400000US40,40,Oklahoma,,2015,1100,Police Protection Total,1915,10001394,39,53478,3074,1932,1954,10054872
0400000US40,40,Oklahoma,,2015,1101,Police Protection - Persons with Power of Arrest       ,952,6072694,2,6067,156,953,954,6078761
0400000US40,40,Oklahoma,,2015,1102,Police Protection - Other ,963,3928700,37,47411,2918,979,1000,3976111
0400000US40,40,Oklahoma,,2015,1120,Fire Protection Total ,0,0,0,0,0,0,0,0
0400000US40,40,Oklahoma,,2015,1121,Fire Protection - Firefighters,0,0,0,0,0,0,0,0
0400000US40,40,Oklahoma,,2015,1122,Fire Protection - Other ,0,0,0,0,0,0,0,0
0400000US40,40,Oklahoma,,2015,1140,Corrections,4472,15734762,46,103647,3549,4492,4518,15838409
0400000US40,40,Oklahoma,,2015,1160,Highways,2867,10799035,0,0,0,2867,2867,10799035
0400000US40,40,Oklahoma,,2015,1180,Air Transportation,11,52825,1,1095,18,11,12,53920
0400000US40,40,Oklahoma,,2015,1200,Water Transport and Terminals       ,0,0,0,0,0,0,0,0
0400000US40,40,Oklahoma,,2015,1220,Public Welfare,8381,24135754,190,208632,18175,8485,8571,24344386
0400000US40,40,Oklahoma,,2015,1240,Health,5351,21167590,258,509988,22865,5481,5609,21677578
0400000US40,40,Oklahoma,,2015,1260,Hospitals,1150,3606260,54,71261,4916,1176,1204,3677521
0400000US40,40,Oklahoma,,2015,1280,Social Insurance Administration,889,3349995,69,348371,7363,930,958,3698366
0400000US40,40,Oklahoma,,2015,1300,Solid Waste Management,76,377790,9,8808,786,80,85,386598
0400000US40,40,Oklahoma,,2015,1320,Sewerage,0,0,0,0,0,0,0,0
0400000US40,40,Oklahoma,,2015,1340,Parks and Recreation,570,1677054,278,284907,26566,721,848,1961961
0400000US40,40,Oklahoma,,2015,1360,Housing and Community Development,0,0,0,0,0,0,0,0
0400000US40,40,Oklahoma,,2015,1380,Natural Resources,1564,5737841,808,741985,43905,1810,2372,6479826
0400000US40,40,Oklahoma,,2015,1400,Water Supply,0,0,0,0,0,0,0,0
0400000US40,40,Oklahoma,,2015,1420,Electric Power,623,3740484,24,35912,1577,632,647,3776396
0400000US40,40,Oklahoma,,2015,1440,Gas Supply,0,0,0,0,0,0,0,0
0400000US40,40,Oklahoma,,2015,1460,Transit,0,0,0,0,0,0,0,0
0400000US40,40,Oklahoma,,2015,1480,Education Total ,24375,117354569,24051,20680421,1277589,31610,48426,138034990
0400000US40,40,Oklahoma,,2015,1481,Education - Elementary and Secondary Total ,0,0,0,0,0,0,0,0
0400000US40,40,Oklahoma,,2015,14811,Education - Elementary and Secondary Instructional             ,0,0,0,0,0,0,0,0
0400000US40,40,Oklahoma,,2015,14812,Education - Elementary and Secondary Other ,0,0,0,0,0,0,0,0
0400000US40,40,Oklahoma,,2015,1482,Education - Higher Education Total ,22760,110905045,23992,20609443,1273202,29971,46752,131514488
0400000US40,40,Oklahoma,,2015,14821,Education - Higher Education Instructional,7014,49248917,7020,9668024,361237,9060,14034,58916941
0400000US40,40,Oklahoma,,2015,14822,Education - Higher Education Other ,15746,61656128,16972,10941419,911965,20911,32718,72597547
0400000US40,40,Oklahoma,,2015,1483,Education - Other,1615,6449524,59,70978,4387,1639,1674,6520502
0400000US40,40,Oklahoma,,2015,1500,Libraries                          ,0,0,0,0,0,0,0,0
0400000US40,40,Oklahoma,,2015,1560,State liquor stores,0,0,0,0,0,0,0,0
0400000US40,40,Oklahoma,,2015,1580,All other and unallocable,2312,9770326,107,157588,8286,2359,2419,9927914
0400000US41,41,Oregon,,2015,1000,Total - All Government Employment Functions,59468,292846600,24916,38696973,1293567,66775,84384,331543573
0400000US41,41,Oregon,,2015,1020,Financial Administration,3960,18550640,168,265271,14618,4044,4128,18815911
0400000US41,41,Oregon,,2015,1040,Other Government Administration,946,4800091,165,333923,15284,1033,1111,5134014
0400000US41,41,Oregon,,2015,1060,Judicial and Legal,2990,15340205,165,505543,16985,3086,3155,15845748
0400000US41,41,Oregon,,2015,1100,Police Protection Total,1337,7255289,148,132807,5830,1370,1485,7388096
0400000US41,41,Oregon,,2015,1101,Police Protection - Persons with Power of Arrest       ,663,4169964,0,0,0,663,663,4169964
0400000US41,41,Oregon,,2015,1102,Police Protection - Other ,674,3085325,148,132807,5830,707,822,3218132
0400000US41,41,Oregon,,2015,1120,Fire Protection Total ,0,0,0,0,0,0,0,0
0400000US41,41,Oregon,,2015,1121,Fire Protection - Firefighters,0,0,0,0,0,0,0,0
0400000US41,41,Oregon,,2015,1122,Fire Protection - Other ,0,0,0,0,0,0,0,0
0400000US41,41,Oregon,,2015,1140,Corrections,5106,24423822,138,301387,10260,5164,5244,24725209
0400000US41,41,Oregon,,2015,1160,Highways,3553,18732591,154,406610,17229,3650,3707,19139201
0400000US41,41,Oregon,,2015,1180,Air Transportation,12,61257,0,0,0,12,12,61257
0400000US41,41,Oregon,,2015,1200,Water Transport and Terminals       ,0,0,0,0,0,0,0,0
0400000US41,41,Oregon,,2015,1220,Public Welfare,7574,29526006,353,685678,28172,7732,7927,30211684
0400000US41,41,Oregon,,2015,1240,Health,2222,10054560,139,371645,12982,2295,2361,10426205
0400000US41,41,Oregon,,2015,1260,Hospitals,5820,27530393,3499,16092983,207888,6994,9319,43623376
0400000US41,41,Oregon,,2015,1280,Social Insurance Administration,1976,12462349,63,245435,6939,2015,2039,12707784
0400000US41,41,Oregon,,2015,1300,Solid Waste Management,0,0,0,0,0,0,0,0
0400000US41,41,Oregon,,2015,1320,Sewerage,0,0,0,0,0,0,0,0
0400000US41,41,Oregon,,2015,1340,Parks and Recreation,431,1841138,10,21045,1109,437,441,1862183
0400000US41,41,Oregon,,2015,1360,Housing and Community Development,0,0,0,0,0,0,0,0
0400000US41,41,Oregon,,2015,1380,Natural Resources,2401,10957134,278,415114,23075,2531,2679,11372248
0400000US41,41,Oregon,,2015,1400,Water Supply,0,0,0,0,0,0,0,0
0400000US41,41,Oregon,,2015,1420,Electric Power,0,0,0,0,0,0,0,0
0400000US41,41,Oregon,,2015,1440,Gas Supply,0,0,0,0,0,0,0,0
0400000US41,41,Oregon,,2015,1460,Transit,0,0,0,0,0,0,0,0
0400000US41,41,Oregon,,2015,1480,Education Total ,19639,103849022,19502,18759582,927341,24879,39141,122608604
0400000US41,41,Oregon,,2015,1481,Education - Elementary and Secondary Total ,0,0,0,0,0,0,0,0
0400000US41,41,Oregon,,2015,14811,Education - Elementary and Secondary Instructional             ,0,0,0,0,0,0,0,0
0400000US41,41,Oregon,,2015,14812,Education - Elementary and Secondary Other ,0,0,0,0,0,0,0,0
0400000US41,41,Oregon,,2015,1482,Education - Higher Education Total ,18832,99777144,19429,18651951,922205,24042,38261,118429095
0400000US41,41,Oregon,,2015,14821,Education - Higher Education Instructional,10337,67196706,3276,6550010,163328,11260,13613,73746716
0400000US41,41,Oregon,,2015,14822,Education - Higher Education Other ,8495,32580438,16153,12101941,758877,12782,24648,44682379
0400000US41,41,Oregon,,2015,1483,Education - Other,807,4071878,73,107631,5136,837,880,4179509
0400000US41,41,Oregon,,2015,1500,Libraries                          ,0,0,0,0,0,0,0,0
0400000US41,41,Oregon,,2015,1560,State liquor stores,158,704471,9,16689,709,162,167,721160
0400000US41,41,Oregon,,2015,1580,All other and unallocable,1343,6757632,125,143261,5146,1371,1468,6900893
0400000US42,42,Pennsylvania,,2015,1000,Total - All Government Employment Functions,141415,712936606,64863,111792896,3752240,163453,206278,824729502
0400000US42,42,Pennsylvania,,2015,1020,Financial Administration,6267,28888448,1058,2390309,92177,6821,7325,31278757
0400000US42,42,Pennsylvania,,2015,1040,Other Government Administration,2686,12015515,498,2260241,68625,3100,3184,14275756
0400000US42,42,Pennsylvania,,2015,1060,Judicial and Legal,2981,27362138,21,80726,1743,2992,3002,27442864
0400000US42,42,Pennsylvania,,2015,1100,Police Protection Total,6596,41436738,377,1124372,20183,6717,6973,42561110
0400000US42,42,Pennsylvania,,2015,1101,Police Protection - Persons with Power of Arrest       ,5218,32772617,8,16297,578,5221,5226,32788914
0400000US42,42,Pennsylvania,,2015,1102,Police Protection - Other ,1378,8664121,369,1108075,19605,1496,1747,9772196
0400000US42,42,Pennsylvania,,2015,1120,Fire Protection Total ,0,0,0,0,0,0,0,0
0400000US42,42,Pennsylvania,,2015,1121,Fire Protection - Firefighters,0,0,0,0,0,0,0,0
0400000US42,42,Pennsylvania,,2015,1122,Fire Protection - Other ,0,0,0,0,0,0,0,0
0400000US42,42,Pennsylvania,,2015,1140,Corrections,18134,86767497,728,2464600,60239,18497,18862,89232097
0400000US42,42,Pennsylvania,,2015,1160,Highways,12419,50938452,2865,6847061,175781,13471,15284,57785513
0400000US42,42,Pennsylvania,,2015,1180,Air Transportation,119,466169,32,73049,1778,130,151,539218
0400000US42,42,Pennsylvania,,2015,1200,Water Transport and Terminals       ,0,0,0,0,0,0,0,0
0400000US42,42,Pennsylvania,,2015,1220,Public Welfare,10620,42388448,1727,3653604,109816,11282,12347,46042052
0400000US42,42,Pennsylvania,,2015,1240,Health,1645,8441240,378,1142066,12148,1718,2023,9583306
0400000US42,42,Pennsylvania,,2015,1260,Hospitals,10723,38080655,1737,3011824,90455,11256,12460,41092479
0400000US42,42,Pennsylvania,,2015,1280,Social Insurance Administration,3953,16616737,624,1932157,50825,4259,4577,18548894
0400000US42,42,Pennsylvania,,2015,1300,Solid Waste Management,0,0,0,0,0,0,0,0
0400000US42,42,Pennsylvania,,2015,1320,Sewerage,0,0,0,0,0,0,0,0
0400000US42,42,Pennsylvania,,2015,1340,Parks and Recreation,1615,7112210,1393,3683976,164448,2606,3008,10796186
0400000US42,42,Pennsylvania,,2015,1360,Housing and Community Development,0,0,0,0,0,0,0,0
0400000US42,42,Pennsylvania,,2015,1380,Natural Resources,5027,24803093,2575,5402339,129177,5783,7602,30205432
0400000US42,42,Pennsylvania,,2015,1400,Water Supply,0,0,0,0,0,0,0,0
0400000US42,42,Pennsylvania,,2015,1420,Electric Power,0,0,0,0,0,0,0,0
0400000US42,42,Pennsylvania,,2015,1440,Gas Supply,0,0,0,0,0,0,0,0
0400000US42,42,Pennsylvania,,2015,1460,Transit,0,0,0,0,0,0,0,0
0400000US42,42,Pennsylvania,,2015,1480,Education Total ,50107,289899288,47375,71039853,2481800,64535,97482,360939141
0400000US42,42,Pennsylvania,,2015,1481,Education - Elementary and Secondary Total ,0,0,0,0,0,0,0,0
0400000US42,42,Pennsylvania,,2015,14811,Education - Elementary and Secondary Instructional             ,0,0,0,0,0,0,0,0
0400000US42,42,Pennsylvania,,2015,14812,Education - Elementary and Secondary Other ,0,0,0,0,0,0,0,0
0400000US42,42,Pennsylvania,,2015,1482,Education - Higher Education Total ,45081,268629816,46996,70027138,2456215,59357,92077,338656954
0400000US42,42,Pennsylvania,,2015,14821,Education - Higher Education Instructional,15247,131672981,13005,40463468,804892,19858,28252,172136449
0400000US42,42,Pennsylvania,,2015,14822,Education - Higher Education Other ,29834,136956835,33991,29563670,1651323,39499,63825,166520505
0400000US42,42,Pennsylvania,,2015,1483,Education - Other,5026,21269472,379,1012715,25585,5178,5405,22282187
0400000US42,42,Pennsylvania,,2015,1500,Libraries                          ,0,0,0,0,0,0,0,0
0400000US42,42,Pennsylvania,,2015,1560,State liquor stores,3108,11111881,2594,5164204,244225,4579,5702,16276085
0400000US42,42,Pennsylvania,,2015,1580,All other and unallocable,5415,26608097,881,1522515,48820,5707,6296,28130612
0400000US44,44,Rhode Island,,2015,1000,Total - All Government Employment Functions,16866,97331477,7027,6347691,234902,18338,23893,103679168
0400000US44,44,Rhode Island,,2015,1020,Financial Administration,868,4971930,7,31188,753,873,875,5003118
0400000US44,44,Rhode Island,,2015,1040,Other Government Administration,721,3904735,335,347060,8038,773,1056,4251795
0400000US44,44,Rhode Island,,2015,1060,Judicial and Legal,1178,7166785,22,53238,2002,1191,1200,7220023
0400000US44,44,Rhode Island,,2015,1100,Police Protection Total,337,2549732,1,3691,62,337,338,2553423
0400000US44,44,Rhode Island,,2015,1101,Police Protection - Persons with Power of Arrest       ,255,2042437,0,0,0,255,255,2042437
0400000US44,44,Rhode Island,,2015,1102,Police Protection - Other ,82,507295,1,3691,62,82,83,510986
0400000US44,44,Rhode Island,,2015,1120,Fire Protection Total ,0,0,0,0,0,0,0,0
0400000US44,44,Rhode Island,,2015,1121,Fire Protection - Firefighters,0,0,0,0,0,0,0,0
0400000US44,44,Rhode Island,,2015,1122,Fire Protection - Other ,0,0,0,0,0,0,0,0
0400000US44,44,Rhode Island,,2015,1140,Corrections,1486,9819502,6,12734,202,1487,1492,9832236
0400000US44,44,Rhode Island,,2015,1160,Highways,678,3974302,73,81908,5542,711,751,4056210
0400000US44,44,Rhode Island,,2015,1180,Air Transportation,151,986544,1,1063,18,151,152,987607
0400000US44,44,Rhode Island,,2015,1200,Water Transport and Terminals       ,0,0,0,0,0,0,0,0
0400000US44,44,Rhode Island,,2015,1220,Public Welfare,1329,7960150,11,21534,994,1335,1340,7981684
0400000US44,44,Rhode Island,,2015,1240,Health,947,5323313,11,11718,387,950,958,5335031
0400000US44,44,Rhode Island,,2015,1260,Hospitals,833,4323667,7,33628,1045,840,840,4357295
0400000US44,44,Rhode Island,,2015,1280,Social Insurance Administration,375,1995187,19,65144,2400,390,394,2060331
0400000US44,44,Rhode Island,,2015,1300,Solid Waste Management,97,602432,4,7409,257,98,101,609841
0400000US44,44,Rhode Island,,2015,1320,Sewerage,251,1265245,0,0,0,251,251,1265245
0400000US44,44,Rhode Island,,2015,1340,Parks and Recreation,44,189135,1,1052,84,45,45,190187
0400000US44,44,Rhode Island,,2015,1360,Housing and Community Development,0,0,0,0,0,0,0,0
0400000US44,44,Rhode Island,,2015,1380,Natural Resources,369,2200314,0,0,0,369,369,2200314
0400000US44,44,Rhode Island,,2015,1400,Water Supply,0,0,0,0,0,0,0,0
0400000US44,44,Rhode Island,,2015,1420,Electric Power,0,0,0,0,0,0,0,0
0400000US44,44,Rhode Island,,2015,1440,Gas Supply,0,0,0,0,0,0,0,0
0400000US44,44,Rhode Island,,2015,1460,Transit,798,4055163,0,0,0,798,798,4055163
0400000US44,44,Rhode Island,,2015,1480,Education Total ,4795,25998715,6506,5630140,211199,6117,11301,31628855
0400000US44,44,Rhode Island,,2015,1481,Education - Elementary and Secondary Total ,361,1972920,74,67214,7048,414,435,2040134
0400000US44,44,Rhode Island,,2015,14811,Education - Elementary and Secondary Instructional             ,254,1629252,5,7588,166,255,259,1636840
0400000US44,44,Rhode Island,,2015,14812,Education - Elementary and Secondary Other ,107,343668,69,59626,6882,159,176,403294
0400000US44,44,Rhode Island,,2015,1482,Education - Higher Education Total ,3959,21028560,6422,5535187,203287,5222,10381,26563747
0400000US44,44,Rhode Island,,2015,14821,Education - Higher Education Instructional,1394,9096979,2280,3688225,77518,1872,3674,12785204
0400000US44,44,Rhode Island,,2015,14822,Education - Higher Education Other ,2565,11931581,4142,1846962,125769,3350,6707,13778543
0400000US44,44,Rhode Island,,2015,1483,Education - Other,475,2997235,10,27739,864,481,485,3024974
0400000US44,44,Rhode Island,,2015,1500,Libraries                          ,0,0,0,0,0,0,0,0
0400000US44,44,Rhode Island,,2015,1560,State liquor stores,0,0,0,0,0,0,0,0
0400000US44,44,Rhode Island,,2015,1580,All other and unallocable,1609,10044626,23,46184,1919,1622,1632,10090810
0400000US45,45,South Carolina,,2015,1000,Total - All Government Employment Functions,71722,298852593,21919,24280302,1423077,80181,93641,323132895
0400000US45,45,South Carolina,,2015,1020,Financial Administration,3188,11845550,198,373868,24121,3333,3386,12219418
0400000US45,45,South Carolina,,2015,1040,Other Government Administration,578,2400470,488,334635,26766,738,1066,2735105
0400000US45,45,South Carolina,,2015,1060,Judicial and Legal,886,4484506,13,22338,1130,893,899,4506844
0400000US45,45,South Carolina,,2015,1100,Police Protection Total,2039,7899572,39,66530,3994,2063,2078,7966102
0400000US45,45,South Carolina,,2015,1101,Police Protection - Persons with Power of Arrest       ,1381,5723600,9,25174,1004,1387,1390,5748774
0400000US45,45,South Carolina,,2015,1102,Police Protection - Other ,658,2175972,30,41356,2990,676,688,2217328
0400000US45,45,South Carolina,,2015,1120,Fire Protection Total ,0,0,0,0,0,0,0,0
0400000US45,45,South Carolina,,2015,1121,Fire Protection - Firefighters,0,0,0,0,0,0,0,0
0400000US45,45,South Carolina,,2015,1122,Fire Protection - Other ,0,0,0,0,0,0,0,0
0400000US45,45,South Carolina,,2015,1140,Corrections,8028,23617326,86,184922,7462,8072,8114,23802248
0400000US45,45,South Carolina,,2015,1160,Highways,4359,15218892,7,11576,696,4363,4366,15230468
0400000US45,45,South Carolina,,2015,1180,Air Transportation,14,73152,2,2150,86,15,16,75302
0400000US45,45,South Carolina,,2015,1200,Water Transport and Terminals       ,497,2924327,6,6780,228,498,503,2931107
0400000US45,45,South Carolina,,2015,1220,Public Welfare,5131,15296868,14,27184,1518,5140,5145,15324052
0400000US45,45,South Carolina,,2015,1240,Health,5143,18327378,296,765013,31906,5334,5439,19092391
0400000US45,45,South Carolina,,2015,1260,Hospitals,6777,21085634,323,1295446,40672,7012,7100,22381080
0400000US45,45,South Carolina,,2015,1280,Social Insurance Administration,1093,3700346,37,72518,3982,1117,1130,3772864
0400000US45,45,South Carolina,,2015,1300,Solid Waste Management,0,0,0,0,0,0,0,0
0400000US45,45,South Carolina,,2015,1320,Sewerage,0,0,0,0,0,0,0,0
0400000US45,45,South Carolina,,2015,1340,Parks and Recreation,773,1808520,83,71786,6720,814,856,1880306
0400000US45,45,South Carolina,,2015,1360,Housing and Community Development,134,586862,1,280,8,134,135,587142
0400000US45,45,South Carolina,,2015,1380,Natural Resources,2072,6967866,315,233108,30292,2255,2387,7200974
0400000US45,45,South Carolina,,2015,1400,Water Supply,13,85644,0,0,0,13,13,85644
0400000US45,45,South Carolina,,2015,1420,Electric Power,1764,11793171,4,15921,534,1767,1768,11809092
0400000US45,45,South Carolina,,2015,1440,Gas Supply,0,0,0,0,0,0,0,0
0400000US45,45,South Carolina,,2015,1460,Transit,0,0,0,0,0,0,0,0
0400000US45,45,South Carolina,,2015,1480,Education Total ,27619,144647147,19934,20681415,1236720,34968,47553,165328562
0400000US45,45,South Carolina,,2015,1481,Education - Elementary and Secondary Total ,0,0,0,0,0,0,0,0
0400000US45,45,South Carolina,,2015,14811,Education - Elementary and Secondary Instructional             ,0,0,0,0,0,0,0,0
0400000US45,45,South Carolina,,2015,14812,Education - Elementary and Secondary Other ,0,0,0,0,0,0,0,0
0400000US45,45,South Carolina,,2015,1482,Education - Higher Education Total ,24653,133350801,19645,20225685,1214328,31867,44298,153576486
0400000US45,45,South Carolina,,2015,14821,Education - Higher Education Instructional,8903,62421874,7577,9667502,416888,11382,16480,72089376
0400000US45,45,South Carolina,,2015,14822,Education - Higher Education Other ,15750,70928927,12068,10558183,797440,20485,27818,81487110
0400000US45,45,South Carolina,,2015,1483,Education - Other,2966,11296346,289,455730,22392,3101,3255,11752076
0400000US45,45,South Carolina,,2015,1500,Libraries                          ,38,141666,0,0,0,38,38,141666
0400000US45,45,South Carolina,,2015,1560,State liquor stores,0,0,0,0,0,0,0,0
0400000US45,45,South Carolina,,2015,1580,All other and unallocable,1576,5947696,73,114832,6242,1614,1649,6062528
0400000US46,46,South Dakota,,2015,1000,Total - All Government Employment Functions,12639,55444950,6194,5424462,318559,14438,18833,60869412
0400000US46,46,South Dakota,,2015,1020,Financial Administration,439,2252066,16,29158,1751,449,455,2281224
0400000US46,46,South Dakota,,2015,1040,Other Government Administration,345,1543763,72,98947,6628,382,417,1642710
0400000US46,46,South Dakota,,2015,1060,Judicial and Legal,596,3017713,93,146765,8629,645,689,3164478
0400000US46,46,South Dakota,,2015,1100,Police Protection Total,341,1455995,17,28345,1448,349,358,1484340
0400000US46,46,South Dakota,,2015,1101,Police Protection - Persons with Power of Arrest       ,220,1041381,0,0,0,220,220,1041381
0400000US46,46,South Dakota,,2015,1102,Police Protection - Other ,121,414614,17,28345,1448,129,138,442959
0400000US46,46,South Dakota,,2015,1120,Fire Protection Total ,0,0,0,0,0,0,0,0
0400000US46,46,South Dakota,,2015,1121,Fire Protection - Firefighters,0,0,0,0,0,0,0,0
0400000US46,46,South Dakota,,2015,1122,Fire Protection - Other ,0,0,0,0,0,0,0,0
0400000US46,46,South Dakota,,2015,1140,Corrections,838,3128810,31,36122,2411,852,869,3164932
0400000US46,46,South Dakota,,2015,1160,Highways,954,4117958,40,76586,4677,980,994,4194544
0400000US46,46,South Dakota,,2015,1180,Air Transportation,0,0,0,0,0,0,0,0
0400000US46,46,South Dakota,,2015,1200,Water Transport and Terminals       ,0,0,0,0,0,0,0,0
0400000US46,46,South Dakota,,2015,1220,Public Welfare,1661,6515062,148,271429,15514,1748,1809,6786491
0400000US46,46,South Dakota,,2015,1240,Health,499,2432882,151,518471,20949,617,650,2951353
0400000US46,46,South Dakota,,2015,1260,Hospitals,348,1163818,46,57893,3589,368,394,1221711
0400000US46,46,South Dakota,,2015,1280,Social Insurance Administration,235,821044,4,6920,465,238,239,827964
0400000US46,46,South Dakota,,2015,1300,Solid Waste Management,0,0,0,0,0,0,0,0
0400000US46,46,South Dakota,,2015,1320,Sewerage,0,0,0,0,0,0,0,0
0400000US46,46,South Dakota,,2015,1340,Parks and Recreation,119,449482,38,43683,4132,142,157,493165
0400000US46,46,South Dakota,,2015,1360,Housing and Community Development,0,0,0,0,0,0,0,0
0400000US46,46,South Dakota,,2015,1380,Natural Resources,758,3102936,469,499007,30488,930,1227,3601943
0400000US46,46,South Dakota,,2015,1400,Water Supply,0,0,0,0,0,0,0,0
0400000US46,46,South Dakota,,2015,1420,Electric Power,0,0,0,0,0,0,0,0
0400000US46,46,South Dakota,,2015,1440,Gas Supply,0,0,0,0,0,0,0,0
0400000US46,46,South Dakota,,2015,1460,Transit,0,0,0,0,0,0,0,0
0400000US46,46,South Dakota,,2015,1480,Education Total ,4727,21918928,5026,3556673,214133,5937,9753,25475601
0400000US46,46,South Dakota,,2015,1481,Education - Elementary and Secondary Total ,0,0,0,0,0,0,0,0
0400000US46,46,South Dakota,,2015,14811,Education - Elementary and Secondary Instructional             ,0,0,0,0,0,0,0,0
0400000US46,46,South Dakota,,2015,14812,Education - Elementary and Secondary Other ,0,0,0,0,0,0,0,0
0400000US46,46,South Dakota,,2015,1482,Education - Higher Education Total ,4365,20423614,5006,3516933,211826,5562,9371,23940547
0400000US46,46,South Dakota,,2015,14821,Education - Higher Education Instructional,1578,9998842,1533,2200799,87845,2075,3111,12199641
0400000US46,46,South Dakota,,2015,14822,Education - Higher Education Other ,2787,10424772,3473,1316134,123981,3487,6260,11740906
0400000US46,46,South Dakota,,2015,1483,Education - Other,362,1495314,20,39740,2307,375,382,1535054
0400000US46,46,South Dakota,,2015,1500,Libraries                          ,0,0,0,0,0,0,0,0
0400000US46,46,South Dakota,,2015,1560,State liquor stores,0,0,0,0,0,0,0,0
0400000US46,46,South Dakota,,2015,1580,All other and unallocable,779,3524493,43,54463,3745,801,822,3578956
0400000US47,47,Tennessee,,2015,1000,Total - All Government Employment Functions,69874,296917843,26553,24207466,1446011,78383,96427,321125309
0400000US47,47,Tennessee,,2015,1020,Financial Administration,3312,14982170,68,74639,4853,3340,3380,15056809
0400000US47,47,Tennessee,,2015,1040,Other Government Administration,753,3310336,24,15194,655,757,777,3325530
0400000US47,47,Tennessee,,2015,1060,Judicial and Legal,2518,14050902,35,41939,1522,2527,2553,14092841
0400000US47,47,Tennessee,,2015,1100,Police Protection Total,1776,8359332,7,10062,696,1780,1783,8369394
0400000US47,47,Tennessee,,2015,1101,Police Protection - Persons with Power of Arrest       ,1364,6916616,6,6848,570,1367,1370,6923464
0400000US47,47,Tennessee,,2015,1102,Police Protection - Other ,412,1442716,1,3214,126,413,413,1445930
0400000US47,47,Tennessee,,2015,1120,Fire Protection Total ,0,0,0,0,0,0,0,0
0400000US47,47,Tennessee,,2015,1121,Fire Protection - Firefighters,0,0,0,0,0,0,0,0
0400000US47,47,Tennessee,,2015,1122,Fire Protection - Other ,0,0,0,0,0,0,0,0
0400000US47,47,Tennessee,,2015,1140,Corrections,6918,21044024,15,24028,1526,6927,6933,21068052
0400000US47,47,Tennessee,,2015,1160,Highways,3235,12656788,0,0,0,3235,3235,12656788
0400000US47,47,Tennessee,,2015,1180,Air Transportation,0,0,0,0,0,0,0,0
0400000US47,47,Tennessee,,2015,1200,Water Transport and Terminals       ,0,0,0,0,0,0,0,0
0400000US47,47,Tennessee,,2015,1220,Public Welfare,7359,26224764,6,8546,574,7362,7365,26233310
0400000US47,47,Tennessee,,2015,1240,Health,4150,18259999,180,389902,16022,4243,4330,18649901
0400000US47,47,Tennessee,,2015,1260,Hospitals,3611,13497930,114,431018,16428,3705,3725,13928948
0400000US47,47,Tennessee,,2015,1280,Social Insurance Administration,1049,3795280,60,82674,5372,1081,1109,3877954
0400000US47,47,Tennessee,,2015,1300,Solid Waste Management,0,0,0,0,0,0,0,0
0400000US47,47,Tennessee,,2015,1320,Sewerage,0,0,0,0,0,0,0,0
0400000US47,47,Tennessee,,2015,1340,Parks and Recreation,922,2446180,222,165012,17082,1025,1144,2611192
0400000US47,47,Tennessee,,2015,1360,Housing and Community Development,0,0,0,0,0,0,0,0
0400000US47,47,Tennessee,,2015,1380,Natural Resources,3405,14482036,510,701925,50077,3694,3915,15183961
0400000US47,47,Tennessee,,2015,1400,Water Supply,0,0,0,0,0,0,0,0
0400000US47,47,Tennessee,,2015,1420,Electric Power,0,0,0,0,0,0,0,0
0400000US47,47,Tennessee,,2015,1440,Gas Supply,0,0,0,0,0,0,0,0
0400000US47,47,Tennessee,,2015,1460,Transit,0,0,0,0,0,0,0,0
0400000US47,47,Tennessee,,2015,1480,Education Total ,28330,133750038,25138,22080635,1321423,36113,53468,155830673
0400000US47,47,Tennessee,,2015,1481,Education - Elementary and Secondary Total ,0,0,0,0,0,0,0,0
0400000US47,47,Tennessee,,2015,14811,Education - Elementary and Secondary Instructional             ,0,0,0,0,0,0,0,0
0400000US47,47,Tennessee,,2015,14812,Education - Elementary and Secondary Other ,0,0,0,0,0,0,0,0
0400000US47,47,Tennessee,,2015,1482,Education - Higher Education Total ,26457,126475535,24949,21906127,1313626,34192,51406,148381662
0400000US47,47,Tennessee,,2015,14821,Education - Higher Education Instructional,9114,58393031,9999,11729505,594603,12649,19113,70122536
0400000US47,47,Tennessee,,2015,14822,Education - Higher Education Other ,17343,68082504,14950,10176622,719023,21543,32293,78259126
0400000US47,47,Tennessee,,2015,1483,Education - Other,1873,7274503,189,174508,7797,1921,2062,7449011
0400000US47,47,Tennessee,,2015,1500,Libraries                          ,0,0,0,0,0,0,0,0
0400000US47,47,Tennessee,,2015,1560,State liquor stores,0,0,0,0,0,0,0,0
0400000US47,47,Tennessee,,2015,1580,All other and unallocable,2536,10058064,174,181892,9781,2594,2710,10239956
0400000US48,48,Texas,,2015,1000,Total - All Government Employment Functions,270894,1339617810,87684,123439323,5918100,304330,358578,1463057133
0400000US48,48,Texas,,2015,1020,Financial Administration,7588,37055231,365,537031,35248,7786,7953,37592262
0400000US48,48,Texas,,2015,1040,Other Government Administration,2158,9989608,422,474306,28134,2318,2580,10463914
0400000US48,48,Texas,,2015,1060,Judicial and Legal,5537,29876007,174,863991,26119,5686,5711,30739998
0400000US48,48,Texas,,2015,1100,Police Protection Total,6740,44686498,63,78094,5632,6772,6803,44764592
0400000US48,48,Texas,,2015,1101,Police Protection - Persons with Power of Arrest       ,3603,32097154,0,0,0,3603,3603,32097154
0400000US48,48,Texas,,2015,1102,Police Protection - Other ,3137,12589344,63,78094,5632,3169,3200,12667438
0400000US48,48,Texas,,2015,1120,Fire Protection Total ,0,0,0,0,0,0,0,0
0400000US48,48,Texas,,2015,1121,Fire Protection - Firefighters,0,0,0,0,0,0,0,0
0400000US48,48,Texas,,2015,1122,Fire Protection - Other ,0,0,0,0,0,0,0,0
0400000US48,48,Texas,,2015,1140,Corrections,39072,120544142,542,772739,46038,39332,39614,121316881
0400000US48,48,Texas,,2015,1160,Highways,12646,56592859,323,867677,28122,12806,12969,57460536
0400000US48,48,Texas,,2015,1180,Air Transportation,0,0,0,0,0,0,0,0
0400000US48,48,Texas,,2015,1200,Water Transport and Terminals       ,0,0,0,0,0,0,0,0
0400000US48,48,Texas,,2015,1220,Public Welfare,23818,79856172,56,130641,5710,23850,23874,79986813
0400000US48,48,Texas,,2015,1240,Health,18920,85614584,444,1325102,48130,19192,19364,86939686
0400000US48,48,Texas,,2015,1260,Hospitals,21511,91023619,2746,11181987,317554,23304,24257,102205606
0400000US48,48,Texas,,2015,1280,Social Insurance Administration,3727,14082316,30,60511,2622,3742,3757,14142827
0400000US48,48,Texas,,2015,1300,Solid Waste Management,0,0,0,0,0,0,0,0
0400000US48,48,Texas,,2015,1320,Sewerage,0,0,0,0,0,0,0,0
0400000US48,48,Texas,,2015,1340,Parks and Recreation,1144,3851422,136,161970,13693,1221,1280,4013392
0400000US48,48,Texas,,2015,1360,Housing and Community Development,0,0,0,0,0,0,0,0
0400000US48,48,Texas,,2015,1380,Natural Resources,9767,46204095,2535,2910482,169352,10725,12302,49114577
0400000US48,48,Texas,,2015,1400,Water Supply,0,0,0,0,0,0,0,0
0400000US48,48,Texas,,2015,1420,Electric Power,0,0,0,0,0,0,0,0
0400000US48,48,Texas,,2015,1440,Gas Supply,0,0,0,0,0,0,0,0
0400000US48,48,Texas,,2015,1460,Transit,0,0,0,0,0,0,0,0
0400000US48,48,Texas,,2015,1480,Education Total ,110742,683458429,79601,103548924,5168871,139945,190343,787007353
0400000US48,48,Texas,,2015,1481,Education - Elementary and Secondary Total ,16,56579,4,6149,241,17,20,62728
0400000US48,48,Texas,,2015,14811,Education - Elementary and Secondary Instructional             ,14,49366,4,6149,241,15,18,55515
0400000US48,48,Texas,,2015,14812,Education - Elementary and Secondary Other ,2,7213,0,0,0,2,2,7213
0400000US48,48,Texas,,2015,1482,Education - Higher Education Total ,106540,663538711,79281,102548539,5127653,135512,185821,766087250
0400000US48,48,Texas,,2015,14821,Education - Higher Education Instructional,27590,286240242,29975,53982431,1950620,38613,57565,340222673
0400000US48,48,Texas,,2015,14822,Education - Higher Education Other ,78950,377298469,49306,48566108,3177033,96899,128256,425864577
0400000US48,48,Texas,,2015,1483,Education - Other,4186,19863139,316,994236,40977,4416,4502,20857375
0400000US48,48,Texas,,2015,1500,Libraries                          ,0,0,0,0,0,0,0,0
0400000US48,48,Texas,,2015,1560,State liquor stores,0,0,0,0,0,0,0,0
0400000US48,48,Texas,,2015,1580,All other and unallocable,7524,36782828,247,525868,22875,7651,7771,37308696
0400000US49,49,Utah,,2015,1000,Total - All Government Employment Functions,46901,225512153,27385,30566845,1499897,55380,74286,256078998
0400000US49,49,Utah,,2015,1020,Financial Administration,2363,11321305,140,280283,13931,2442,2503,11601588
0400000US49,49,Utah,,2015,1040,Other Government Administration,336,1798359,172,318365,19737,448,508,2116724
0400000US49,49,Utah,,2015,1060,Judicial and Legal,1469,7503413,123,210651,11005,1531,1592,7714064
0400000US49,49,Utah,,2015,1100,Police Protection Total,875,3673879,98,113308,6437,911,973,3787187
0400000US49,49,Utah,,2015,1101,Police Protection - Persons with Power of Arrest       ,483,2273210,17,19515,1247,490,500,2292725
0400000US49,49,Utah,,2015,1102,Police Protection - Other ,392,1400669,81,93793,5190,421,473,1494462
0400000US49,49,Utah,,2015,1120,Fire Protection Total ,0,0,0,0,0,0,0,0
0400000US49,49,Utah,,2015,1121,Fire Protection - Firefighters,0,0,0,0,0,0,0,0
0400000US49,49,Utah,,2015,1122,Fire Protection - Other ,0,0,0,0,0,0,0,0
0400000US49,49,Utah,,2015,1140,Corrections,2980,10855874,208,223311,17058,3076,3188,11079185
0400000US49,49,Utah,,2015,1160,Highways,1528,6794941,33,58406,3605,1548,1561,6853347
0400000US49,49,Utah,,2015,1180,Air Transportation,0,0,0,0,0,0,0,0
0400000US49,49,Utah,,2015,1200,Water Transport and Terminals       ,0,0,0,0,0,0,0,0
0400000US49,49,Utah,,2015,1220,Public Welfare,2380,8246370,121,274652,13813,2457,2501,8521022
0400000US49,49,Utah,,2015,1240,Health,1795,7574534,231,441585,18774,1902,2026,8016119
0400000US49,49,Utah,,2015,1260,Hospitals,8816,37227964,1242,2084707,77123,9251,10058,39312671
0400000US49,49,Utah,,2015,1280,Social Insurance Administration,1015,3889809,28,77256,3366,1034,1043,3967065
0400000US49,49,Utah,,2015,1300,Solid Waste Management,0,0,0,0,0,0,0,0
0400000US49,49,Utah,,2015,1320,Sewerage,0,0,0,0,0,0,0,0
0400000US49,49,Utah,,2015,1340,Parks and Recreation,250,813712,57,52696,4652,277,307,866408
0400000US49,49,Utah,,2015,1360,Housing and Community Development,0,0,0,0,0,0,0,0
0400000US49,49,Utah,,2015,1380,Natural Resources,1214,4901747,254,275265,15610,1303,1468,5177012
0400000US49,49,Utah,,2015,1400,Water Supply,0,0,0,0,0,0,0,0
0400000US49,49,Utah,,2015,1420,Electric Power,0,0,0,0,0,0,0,0
0400000US49,49,Utah,,2015,1440,Gas Supply,0,0,0,0,0,0,0,0
0400000US49,49,Utah,,2015,1460,Transit,0,0,0,0,0,0,0,0
0400000US49,49,Utah,,2015,1480,Education Total ,20141,113936923,24220,25714641,1260378,27264,44361,139651564
0400000US49,49,Utah,,2015,1481,Education - Elementary and Secondary Total ,0,0,0,0,0,0,0,0
0400000US49,49,Utah,,2015,14811,Education - Elementary and Secondary Instructional             ,0,0,0,0,0,0,0,0
0400000US49,49,Utah,,2015,14812,Education - Elementary and Secondary Other ,0,0,0,0,0,0,0,0
0400000US49,49,Utah,,2015,1482,Education - Higher Education Total ,18569,107177169,23155,24615160,1197995,25338,41724,131792329
0400000US49,49,Utah,,2015,14821,Education - Higher Education Instructional,5846,52621228,8792,14251853,435378,8305,14638,66873081
0400000US49,49,Utah,,2015,14822,Education - Higher Education Other ,12723,54555941,14363,10363307,762617,17033,27086,64919248
0400000US49,49,Utah,,2015,1483,Education - Other,1572,6759754,1065,1099481,62383,1926,2637,7859235
0400000US49,49,Utah,,2015,1500,Libraries                          ,0,0,0,0,0,0,0,0
0400000US49,49,Utah,,2015,1560,State liquor stores,282,677879,290,204124,21738,405,572,882003
0400000US49,49,Utah,,2015,1580,All other and unallocable,1457,6295444,168,237595,12670,1531,1625,6533039
0400000US50,50,Vermont,,2015,1000,Total - All Government Employment Functions,13348,66934731,4039,6937139,207474,14564,17387,73871870
0400000US50,50,Vermont,,2015,1020,Financial Administration,621,3101465,16,15728,936,627,637,3117193
0400000US50,50,Vermont,,2015,1040,Other Government Administration,464,2039792,210,558209,4492,489,674,2598001
0400000US50,50,Vermont,,2015,1060,Judicial and Legal,674,3392356,30,26178,1083,679,704,3418534
0400000US50,50,Vermont,,2015,1100,Police Protection Total,612,3447078,76,42001,2345,625,688,3489079
0400000US50,50,Vermont,,2015,1101,Police Protection - Persons with Power of Arrest       ,296,1995800,1,806,38,296,297,1996606
0400000US50,50,Vermont,,2015,1102,Police Protection - Other ,316,1451278,75,41195,2307,329,391,1492473
0400000US50,50,Vermont,,2015,1120,Fire Protection Total ,0,0,0,0,0,0,0,0
0400000US50,50,Vermont,,2015,1121,Fire Protection - Firefighters,0,0,0,0,0,0,0,0
0400000US50,50,Vermont,,2015,1122,Fire Protection - Other ,0,0,0,0,0,0,0,0
0400000US50,50,Vermont,,2015,1140,Corrections,1107,5036980,2,1864,97,1108,1109,5038844
0400000US50,50,Vermont,,2015,1160,Highways,1044,5102879,5,1940,102,1045,1049,5104819
0400000US50,50,Vermont,,2015,1180,Air Transportation,0,0,0,0,0,0,0,0
0400000US50,50,Vermont,,2015,1200,Water Transport and Terminals       ,0,0,0,0,0,0,0,0
0400000US50,50,Vermont,,2015,1220,Public Welfare,1580,7182596,35,31518,1152,1586,1615,7214114
0400000US50,50,Vermont,,2015,1240,Health,509,2530326,31,11184,735,513,540,2541510
0400000US50,50,Vermont,,2015,1260,Hospitals,249,1181538,5,9471,219,250,254,1191009
0400000US50,50,Vermont,,2015,1280,Social Insurance Administration,278,1183881,3,1849,66,278,281,1185730
0400000US50,50,Vermont,,2015,1300,Solid Waste Management,0,0,0,0,0,0,0,0
0400000US50,50,Vermont,,2015,1320,Sewerage,0,0,0,0,0,0,0,0
0400000US50,50,Vermont,,2015,1340,Parks and Recreation,117,525167,4,1557,100,118,121,526724
0400000US50,50,Vermont,,2015,1360,Housing and Community Development,0,0,0,0,0,0,0,0
0400000US50,50,Vermont,,2015,1380,Natural Resources,613,3118885,12,20031,823,618,625,3138916
0400000US50,50,Vermont,,2015,1400,Water Supply,0,0,0,0,0,0,0,0
0400000US50,50,Vermont,,2015,1420,Electric Power,0,0,0,0,0,0,0,0
0400000US50,50,Vermont,,2015,1440,Gas Supply,0,0,0,0,0,0,0,0
0400000US50,50,Vermont,,2015,1460,Transit,0,0,0,0,0,0,0,0
0400000US50,50,Vermont,,2015,1480,Education Total ,4184,22422157,3523,6139318,190867,5307,7707,28561475
0400000US50,50,Vermont,,2015,1481,Education - Elementary and Secondary Total ,0,0,0,0,0,0,0,0
0400000US50,50,Vermont,,2015,14811,Education - Elementary and Secondary Instructional             ,0,0,0,0,0,0,0,0
0400000US50,50,Vermont,,2015,14812,Education - Elementary and Secondary Other ,0,0,0,0,0,0,0,0
0400000US50,50,Vermont,,2015,1482,Education - Higher Education Total ,3763,20358262,3512,6109856,189676,4879,7275,26468118
0400000US50,50,Vermont,,2015,14821,Education - Higher Education Instructional,957,8247969,1117,2319786,50831,1253,2074,10567755
0400000US50,50,Vermont,,2015,14822,Education - Higher Education Other ,2806,12110293,2395,3790070,138845,3626,5201,15900363
0400000US50,50,Vermont,,2015,1483,Education - Other,421,2063895,11,29462,1191,428,432,2093357
0400000US50,50,Vermont,,2015,1500,Libraries                          ,0,0,0,0,0,0,0,0
0400000US50,50,Vermont,,2015,1560,State liquor stores,55,262333,0,0,0,55,55,262333
0400000US50,50,Vermont,,2015,1580,All other and unallocable,1241,6407298,87,76291,4457,1266,1328,6483589
0400000US51,51,Virginia,,2015,1000,Total - All Government Employment Functions,106533,524262718,58488,68639883,3399587,125749,165021,592902601
0400000US51,51,Virginia,,2015,1020,Financial Administration,4073,18534732,526,745250,58609,4403,4599,19279982
0400000US51,51,Virginia,,2015,1040,Other Government Administration,558,3236888,323,685054,30575,737,881,3921942
0400000US51,51,Virginia,,2015,1060,Judicial and Legal,3757,18439384,305,347030,13570,3833,4062,18786414
0400000US51,51,Virginia,,2015,1100,Police Protection Total,3132,15068190,149,247162,12390,3202,3281,15315352
0400000US51,51,Virginia,,2015,1101,Police Protection - Persons with Power of Arrest       ,2366,12287454,12,18718,1140,2372,2378,12306172
0400000US51,51,Virginia,,2015,1102,Police Protection - Other ,766,2780736,137,228444,11250,830,903,3009180
0400000US51,51,Virginia,,2015,1120,Fire Protection Total ,0,0,0,0,0,0,0,0
0400000US51,51,Virginia,,2015,1121,Fire Protection - Firefighters,0,0,0,0,0,0,0,0
0400000US51,51,Virginia,,2015,1122,Fire Protection - Other ,0,0,0,0,0,0,0,0
0400000US51,51,Virginia,,2015,1140,Corrections,13027,43408142,334,514106,29262,13192,13361,43922248
0400000US51,51,Virginia,,2015,1160,Highways,7248,38642762,646,1382678,63550,7607,7894,40025440
0400000US51,51,Virginia,,2015,1180,Air Transportation,0,0,0,0,0,0,0,0
0400000US51,51,Virginia,,2015,1200,Water Transport and Terminals       ,137,769700,0,0,0,137,137,769700
0400000US51,51,Virginia,,2015,1220,Public Welfare,2845,12301896,337,566436,27664,3001,3182,12868332
0400000US51,51,Virginia,,2015,1240,Health,6651,29183630,840,1813246,74248,7070,7491,30996876
0400000US51,51,Virginia,,2015,1260,Hospitals,12267,52182692,1593,4064347,113296,12909,13860,56247039
0400000US51,51,Virginia,,2015,1280,Social Insurance Administration,1163,4518814,310,551062,29992,1332,1473,5069876
0400000US51,51,Virginia,,2015,1300,Solid Waste Management,0,0,0,0,0,0,0,0
0400000US51,51,Virginia,,2015,1320,Sewerage,0,0,0,0,0,0,0,0
0400000US51,51,Virginia,,2015,1340,Parks and Recreation,651,2519296,947,750577,65597,1022,1598,3269873
0400000US51,51,Virginia,,2015,1360,Housing and Community Development,0,0,0,0,0,0,0,0
0400000US51,51,Virginia,,2015,1380,Natural Resources,2249,11798629,630,1251237,88469,2748,2879,13049866
0400000US51,51,Virginia,,2015,1400,Water Supply,0,0,0,0,0,0,0,0
0400000US51,51,Virginia,,2015,1420,Electric Power,0,0,0,0,0,0,0,0
0400000US51,51,Virginia,,2015,1440,Gas Supply,0,0,0,0,0,0,0,0
0400000US51,51,Virginia,,2015,1460,Transit,0,0,0,0,0,0,0,0
0400000US51,51,Virginia,,2015,1480,Education Total ,44271,252384316,48429,53039758,2593898,58929,92700,305424074
0400000US51,51,Virginia,,2015,1481,Education - Elementary and Secondary Total ,0,0,0,0,0,0,0,0
0400000US51,51,Virginia,,2015,14811,Education - Elementary and Secondary Instructional             ,0,0,0,0,0,0,0,0
0400000US51,51,Virginia,,2015,14812,Education - Elementary and Secondary Other ,0,0,0,0,0,0,0,0
0400000US51,51,Virginia,,2015,1482,Education - Higher Education Total ,42293,242515514,48100,52486836,2568834,56809,90393,295002350
0400000US51,51,Virginia,,2015,14821,Education - Higher Education Instructional,15970,123050116,14871,22760813,757100,20248,30841,145810929
0400000US51,51,Virginia,,2015,14822,Education - Higher Education Other ,26323,119465398,33229,29726023,1811734,36561,59552,149191421
0400000US51,51,Virginia,,2015,1483,Education - Other,1978,9868802,329,552922,25064,2120,2307,10421724
0400000US51,51,Virginia,,2015,1500,Libraries                          ,0,0,0,0,0,0,0,0
0400000US51,51,Virginia,,2015,1560,State liquor stores,942,3258664,2345,1788835,160722,1850,3287,5047499
0400000US51,51,Virginia,,2015,1580,All other and unallocable,3562,18014983,774,893105,37745,3777,4336,18908088
0400000US53,53,Washington,,2015,1000,Total - All Government Employment Functions,102285,532801371,53796,88959810,3525942,122220,156081,621761181
0400000US53,53,Washington,,2015,1020,Financial Administration,2699,14380326,181,551956,19866,2811,2880,14932282
0400000US53,53,Washington,,2015,1040,Other Government Administration,571,2808370,606,2014878,67831,956,1177,4823248
0400000US53,53,Washington,,2015,1060,Judicial and Legal,1924,11590052,121,423564,12136,1992,2045,12013616
0400000US53,53,Washington,,2015,1100,Police Protection Total,2200,10921777,38,119117,1948,2211,2238,11040894
0400000US53,53,Washington,,2015,1101,Police Protection - Persons with Power of Arrest       ,811,5420444,0,0,0,811,811,5420444
0400000US53,53,Washington,,2015,1102,Police Protection - Other ,1389,5501333,38,119117,1948,1400,1427,5620450
0400000US53,53,Washington,,2015,1120,Fire Protection Total ,0,0,0,0,0,0,0,0
0400000US53,53,Washington,,2015,1121,Fire Protection - Firefighters,0,0,0,0,0,0,0,0
0400000US53,53,Washington,,2015,1122,Fire Protection - Other ,0,0,0,0,0,0,0,0
0400000US53,53,Washington,,2015,1140,Corrections,7999,33234548,632,1711202,70740,8399,8631,34945750
0400000US53,53,Washington,,2015,1160,Highways,6230,32477510,484,1401236,51866,6522,6714,33878746
0400000US53,53,Washington,,2015,1180,Air Transportation,0,0,0,0,0,0,0,0
0400000US53,53,Washington,,2015,1200,Water Transport and Terminals       ,2,12712,0,0,0,2,2,12712
0400000US53,53,Washington,,2015,1220,Public Welfare,9900,43677726,998,2613594,106822,10503,10898,46291320
0400000US53,53,Washington,,2015,1240,Health,6219,26938170,828,2073554,90198,6728,7047,29011724
0400000US53,53,Washington,,2015,1260,Hospitals,8555,48703774,3366,13640522,279994,10137,11921,62344296
0400000US53,53,Washington,,2015,1280,Social Insurance Administration,3225,14676114,238,714812,27028,3377,3463,15390926
0400000US53,53,Washington,,2015,1300,Solid Waste Management,516,2782816,66,248464,7838,560,582,3031280
0400000US53,53,Washington,,2015,1320,Sewerage,0,0,0,0,0,0,0,0
0400000US53,53,Washington,,2015,1340,Parks and Recreation,498,2341522,77,213182,8112,544,575,2554704
0400000US53,53,Washington,,2015,1360,Housing and Community Development,64,395160,3,6058,308,66,67,401218
0400000US53,53,Washington,,2015,1380,Natural Resources,4499,20296826,875,1516966,62962,4854,5374,21813792
0400000US53,53,Washington,,2015,1400,Water Supply,0,0,0,0,0,0,0,0
0400000US53,53,Washington,,2015,1420,Electric Power,0,0,0,0,0,0,0,0
0400000US53,53,Washington,,2015,1440,Gas Supply,0,0,0,0,0,0,0,0
0400000US53,53,Washington,,2015,1460,Transit,0,0,0,0,0,0,0,0
0400000US53,53,Washington,,2015,1480,Education Total ,43214,247305546,44947,60857025,2685123,58403,88161,308162571
0400000US53,53,Washington,,2015,1481,Education - Elementary and Secondary Total ,0,0,0,0,0,0,0,0
0400000US53,53,Washington,,2015,14811,Education - Elementary and Secondary Instructional             ,0,0,0,0,0,0,0,0
0400000US53,53,Washington,,2015,14812,Education - Elementary and Secondary Other ,0,0,0,0,0,0,0,0
0400000US53,53,Washington,,2015,1482,Education - Higher Education Total ,41276,237989384,44350,59913667,2646893,56248,85626,297903051
0400000US53,53,Washington,,2015,14821,Education - Higher Education Instructional,13547,103126518,10727,29174685,608565,16991,24274,132301203
0400000US53,53,Washington,,2015,14822,Education - Higher Education Other ,27729,134862866,33623,30738982,2038328,39257,61352,165601848
0400000US53,53,Washington,,2015,1483,Education - Other,1938,9316162,597,943358,38230,2155,2535,10259520
0400000US53,53,Washington,,2015,1500,Libraries                          ,0,0,0,0,0,0,0,0
0400000US53,53,Washington,,2015,1560,State liquor stores,103,524786,9,32260,1042,109,112,557046
0400000US53,53,Washington,,2015,1580,All other and unallocable,3867,19733636,327,821420,32128,4046,4194,20555056
0400000US54,54,West Virginia,,2015,1000,Total - All Government Employment Functions,36408,137967212,12421,11536465,619678,40096,48829,149503677
0400000US54,54,West Virginia,,2015,1020,Financial Administration,1890,5799662,59,84764,4356,1915,1949,5884426
0400000US54,54,West Virginia,,2015,1040,Other Government Administration,206,798510,268,656641,21380,341,474,1455151
0400000US54,54,West Virginia,,2015,1060,Judicial and Legal,1630,7576099,33,61410,3316,1649,1663,7637509
0400000US54,54,West Virginia,,2015,1100,Police Protection Total,1063,4014710,26,19346,1522,1072,1089,4034056
0400000US54,54,West Virginia,,2015,1101,Police Protection - Persons with Power of Arrest       ,653,2859118,0,0,0,653,653,2859118
0400000US54,54,West Virginia,,2015,1102,Police Protection - Other ,410,1155592,26,19346,1522,419,436,1174938
0400000US54,54,West Virginia,,2015,1120,Fire Protection Total ,0,0,0,0,0,0,0,0
0400000US54,54,West Virginia,,2015,1121,Fire Protection - Firefighters,0,0,0,0,0,0,0,0
0400000US54,54,West Virginia,,2015,1122,Fire Protection - Other ,0,0,0,0,0,0,0,0
0400000US54,54,West Virginia,,2015,1140,Corrections,3460,9128979,46,73836,6837,3498,3506,9202815
0400000US54,54,West Virginia,,2015,1160,Highways,5057,18177593,60,100850,8665,5106,5117,18278443
0400000US54,54,West Virginia,,2015,1180,Air Transportation,2,9802,0,0,0,2,2,9802
0400000US54,54,West Virginia,,2015,1200,Water Transport and Terminals       ,3,11928,0,0,0,3,3,11928
0400000US54,54,West Virginia,,2015,1220,Public Welfare,3379,8928499,91,144060,11008,3441,3470,9072559
0400000US54,54,West Virginia,,2015,1240,Health,784,2652300,63,96248,4556,810,847,2748548
0400000US54,54,West Virginia,,2015,1260,Hospitals,1627,4254940,85,100555,6848,1666,1712,4355495
0400000US54,54,West Virginia,,2015,1280,Social Insurance Administration,555,1676256,66,59272,4484,581,621,1735528
0400000US54,54,West Virginia,,2015,1300,Solid Waste Management,10,39476,0,0,0,10,10,39476
0400000US54,54,West Virginia,,2015,1320,Sewerage,0,0,0,0,0,0,0,0
0400000US54,54,West Virginia,,2015,1340,Parks and Recreation,362,779826,418,365806,43446,607,780,1145632
0400000US54,54,West Virginia,,2015,1360,Housing and Community Development,0,0,0,0,0,0,0,0
0400000US54,54,West Virginia,,2015,1380,Natural Resources,1845,6530858,162,173348,11754,1912,2007,6704206
0400000US54,54,West Virginia,,2015,1400,Water Supply,0,0,0,0,0,0,0,0
0400000US54,54,West Virginia,,2015,1420,Electric Power,0,0,0,0,0,0,0,0
0400000US54,54,West Virginia,,2015,1440,Gas Supply,0,0,0,0,0,0,0,0
0400000US54,54,West Virginia,,2015,1460,Transit,8,30230,0,0,0,8,8,30230
0400000US54,54,West Virginia,,2015,1480,Education Total ,12095,59354759,10939,9481947,484768,15005,23034,68836706
0400000US54,54,West Virginia,,2015,1481,Education - Elementary and Secondary Total ,0,0,0,0,0,0,0,0
0400000US54,54,West Virginia,,2015,14811,Education - Elementary and Secondary Instructional             ,0,0,0,0,0,0,0,0
0400000US54,54,West Virginia,,2015,14812,Education - Elementary and Secondary Other ,0,0,0,0,0,0,0,0
0400000US54,54,West Virginia,,2015,1482,Education - Higher Education Total ,10889,54238421,10806,9236831,474980,13741,21695,63475252
0400000US54,54,West Virginia,,2015,14821,Education - Higher Education Instructional,4026,26004317,4120,5833741,159658,4983,8146,31838058
0400000US54,54,West Virginia,,2015,14822,Education - Higher Education Other ,6863,28234104,6686,3403090,315322,8758,13549,31637194
0400000US54,54,West Virginia,,2015,1483,Education - Other,1206,5116338,133,245116,9788,1264,1339,5361454
0400000US54,54,West Virginia,,2015,1500,Libraries                          ,0,0,0,0,0,0,0,0
0400000US54,54,West Virginia,,2015,1560,State liquor stores,74,205496,4,5940,496,77,78,211436
0400000US54,54,West Virginia,,2015,1580,All other and unallocable,2358,7997289,101,112442,6242,2393,2459,8109731
0400000US55,55,Wisconsin,,2015,1000,Total - All Government Employment Functions,58731,306494909,50987,50839281,2770618,74383,109718,357334190
0400000US55,55,Wisconsin,,2015,1020,Financial Administration,2322,11348833,295,551679,35152,2521,2617,11900512
0400000US55,55,Wisconsin,,2015,1040,Other Government Administration,499,2407585,273,680745,35437,700,772,3088330
0400000US55,55,Wisconsin,,2015,1060,Judicial and Legal,1986,13002317,239,720606,25027,2127,2225,13722923
0400000US55,55,Wisconsin,,2015,1100,Police Protection Total,882,4512984,29,48902,2604,897,911,4561886
0400000US55,55,Wisconsin,,2015,1101,Police Protection - Persons with Power of Arrest       ,542,2979722,3,3820,153,543,545,2983542
0400000US55,55,Wisconsin,,2015,1102,Police Protection - Other ,340,1533262,26,45082,2451,354,366,1578344
0400000US55,55,Wisconsin,,2015,1120,Fire Protection Total ,0,0,0,0,0,0,0,0
0400000US55,55,Wisconsin,,2015,1121,Fire Protection - Firefighters,0,0,0,0,0,0,0,0
0400000US55,55,Wisconsin,,2015,1122,Fire Protection - Other ,0,0,0,0,0,0,0,0
0400000US55,55,Wisconsin,,2015,1140,Corrections,9180,39429901,547,2047229,54691,9489,9727,41477130
0400000US55,55,Wisconsin,,2015,1160,Highways,1498,8368911,82,135415,6253,1533,1580,8504326
0400000US55,55,Wisconsin,,2015,1180,Air Transportation,0,0,0,0,0,0,0,0
0400000US55,55,Wisconsin,,2015,1200,Water Transport and Terminals       ,0,0,0,0,0,0,0,0
0400000US55,55,Wisconsin,,2015,1220,Public Welfare,1944,8674001,367,934449,49462,2223,2311,9608450
0400000US55,55,Wisconsin,,2015,1240,Health,1616,8195899,324,911031,33976,1808,1940,9106930
0400000US55,55,Wisconsin,,2015,1260,Hospitals,3430,13988225,496,1553169,53386,3732,3926,15541394
0400000US55,55,Wisconsin,,2015,1280,Social Insurance Administration,904,3820228,76,166111,9909,960,980,3986339
0400000US55,55,Wisconsin,,2015,1300,Solid Waste Management,0,0,0,0,0,0,0,0
0400000US55,55,Wisconsin,,2015,1320,Sewerage,0,0,0,0,0,0,0,0
0400000US55,55,Wisconsin,,2015,1340,Parks and Recreation,138,612427,51,57351,3100,156,189,669778
0400000US55,55,Wisconsin,,2015,1360,Housing and Community Development,0,0,0,0,0,0,0,0
0400000US55,55,Wisconsin,,2015,1380,Natural Resources,2078,9678869,1015,1314757,72869,2488,3093,10993626
0400000US55,55,Wisconsin,,2015,1400,Water Supply,0,0,0,0,0,0,0,0
0400000US55,55,Wisconsin,,2015,1420,Electric Power,0,0,0,0,0,0,0,0
0400000US55,55,Wisconsin,,2015,1440,Gas Supply,0,0,0,0,0,0,0,0
0400000US55,55,Wisconsin,,2015,1460,Transit,0,0,0,0,0,0,0,0
0400000US55,55,Wisconsin,,2015,1480,Education Total ,27641,158419549,46466,40329965,2323347,40767,74107,198749514
0400000US55,55,Wisconsin,,2015,1481,Education - Elementary and Secondary Total ,0,0,0,0,0,0,0,0
0400000US55,55,Wisconsin,,2015,14811,Education - Elementary and Secondary Instructional             ,0,0,0,0,0,0,0,0
0400000US55,55,Wisconsin,,2015,14812,Education - Elementary and Secondary Other ,0,0,0,0,0,0,0,0
0400000US55,55,Wisconsin,,2015,1482,Education - Higher Education Total ,26718,153823961,46148,39529787,2287323,39641,72866,193353748
0400000US55,55,Wisconsin,,2015,14821,Education - Higher Education Instructional,9272,65257508,12680,15079855,713420,13303,21952,80337363
0400000US55,55,Wisconsin,,2015,14822,Education - Higher Education Other ,17446,88566453,33468,24449932,1573903,26338,50914,113016385
0400000US55,55,Wisconsin,,2015,1483,Education - Other,923,4595588,318,800178,36024,1126,1241,5395766
0400000US55,55,Wisconsin,,2015,1500,Libraries                          ,0,0,0,0,0,0,0,0
0400000US55,55,Wisconsin,,2015,1560,State liquor stores,0,0,0,0,0,0,0,0
0400000US55,55,Wisconsin,,2015,1580,All other and unallocable,4613,24035180,727,1387872,65405,4982,5340,25423052
0400000US56,56,Wyoming,,2015,1000,Total - All Government Employment Functions,12178,54502607,3574,3551217,222334,13438,15752,58053824
0400000US56,56,Wyoming,,2015,1020,Financial Administration,734,3763295,6,11781,532,738,740,3775076
0400000US56,56,Wyoming,,2015,1040,Other Government Administration,136,796611,90,149587,8356,183,226,946198
0400000US56,56,Wyoming,,2015,1060,Judicial and Legal,514,2824206,50,209058,5714,546,564,3033264
0400000US56,56,Wyoming,,2015,1100,Police Protection Total,271,1336877,0,0,0,271,271,1336877
0400000US56,56,Wyoming,,2015,1101,Police Protection - Persons with Power of Arrest       ,177,811591,0,0,0,177,177,811591
0400000US56,56,Wyoming,,2015,1102,Police Protection - Other ,94,525286,0,0,0,94,94,525286
0400000US56,56,Wyoming,,2015,1120,Fire Protection Total ,0,0,0,0,0,0,0,0
0400000US56,56,Wyoming,,2015,1121,Fire Protection - Firefighters,0,0,0,0,0,0,0,0
0400000US56,56,Wyoming,,2015,1122,Fire Protection - Other ,0,0,0,0,0,0,0,0
0400000US56,56,Wyoming,,2015,1140,Corrections,1266,4628477,3,5314,354,1268,1269,4633791
0400000US56,56,Wyoming,,2015,1160,Highways,1735,7123115,68,138948,9039,1786,1803,7262063
0400000US56,56,Wyoming,,2015,1180,Air Transportation,0,0,0,0,0,0,0,0
0400000US56,56,Wyoming,,2015,1200,Water Transport and Terminals       ,0,0,0,0,0,0,0,0
0400000US56,56,Wyoming,,2015,1220,Public Welfare,540,2220424,17,27825,2214,553,557,2248249
0400000US56,56,Wyoming,,2015,1240,Health,840,3978690,100,227581,12298,910,940,4206271
0400000US56,56,Wyoming,,2015,1260,Hospitals,675,2353312,23,43621,2639,690,698,2396933
0400000US56,56,Wyoming,,2015,1280,Social Insurance Administration,125,487878,0,0,0,125,125,487878
0400000US56,56,Wyoming,,2015,1300,Solid Waste Management,0,0,0,0,0,0,0,0
0400000US56,56,Wyoming,,2015,1320,Sewerage,0,0,0,0,0,0,0,0
0400000US56,56,Wyoming,,2015,1340,Parks and Recreation,190,847722,54,51261,3405,209,244,898983
0400000US56,56,Wyoming,,2015,1360,Housing and Community Development,0,0,0,0,0,0,0,0
0400000US56,56,Wyoming,,2015,1380,Natural Resources,931,4299707,48,60774,3844,953,979,4360481
0400000US56,56,Wyoming,,2015,1400,Water Supply,0,0,0,0,0,0,0,0
0400000US56,56,Wyoming,,2015,1420,Electric Power,0,0,0,0,0,0,0,0
0400000US56,56,Wyoming,,2015,1440,Gas Supply,0,0,0,0,0,0,0,0
0400000US56,56,Wyoming,,2015,1460,Transit,0,0,0,0,0,0,0,0
0400000US56,56,Wyoming,,2015,1480,Education Total ,3289,15797614,3088,2577892,171493,4258,6377,18375506
0400000US56,56,Wyoming,,2015,1481,Education - Elementary and Secondary Total ,0,0,0,0,0,0,0,0
0400000US56,56,Wyoming,,2015,14811,Education - Elementary and Secondary Instructional             ,0,0,0,0,0,0,0,0
0400000US56,56,Wyoming,,2015,14812,Education - Elementary and Secondary Other ,0,0,0,0,0,0,0,0
0400000US56,56,Wyoming,,2015,1482,Education - Higher Education Total ,3077,14641417,3083,2568123,171006,4043,6160,17209540
0400000US56,56,Wyoming,,2015,14821,Education - Higher Education Instructional,1070,7009189,877,1106268,50863,1357,1947,8115457
0400000US56,56,Wyoming,,2015,14822,Education - Higher Education Other ,2007,7632228,2206,1461855,120143,2686,4213,9094083
0400000US56,56,Wyoming,,2015,1483,Education - Other,212,1156197,5,9769,487,215,217,1165966
0400000US56,56,Wyoming,,2015,1500,Libraries                          ,0,0,0,0,0,0,0,0
0400000US56,56,Wyoming,,2015,1560,State liquor stores,38,145997,0,0,0,38,38,145997
0400000US56,56,Wyoming,,2015,1580,All other and unallocable,894,3898682,27,47575,2446,910,921,3946257
